zK_e8mCa5H0	AKB48	#Sukinanda[NLBP]
t-45WMPbpNs	AKB48	11gatsu no Anklet[NLBP]
H6DD-iYZAkg	AKB48	Aitakatta (VR)[NLBP]
2OB7y6S4hy8	AKB48	Aitakatta[NLBP]
kbSQ_XyOIRs	AKB48	Baby! Baby! Baby![NLBP]
HDn_EK7VRwQ	AKB48	Beginner[NLBP]
5gLSpFwl-dY	AKB48	Boku no YELL[NLBP]
BWXyDAXRY9o	AKB48	Bokutachi wa Tatakawanai[NLBP]
xM0VcWzaiGw	AKB48	Choose me ![NLBP]
E_NkDk49S9I	AKB48	Eien Pressure[NLBP]
AFkT9fFTWvc	AKB48	Enkyori Poster[NLBP]
vEVq_Bx7_KY	AKB48	Everyday, Katyusha[NLBP]
WdhMjzfg6-k	AKB48	Flying Get (Dancing Version)[NLBP]
XHdcW2axwMk	AKB48	Gingham Check[NLBP]
SuhiIItERLo	AKB48	GIVE ME FIVE ![NLBP]
8r7SGQ4c4fQ	AKB48	Green Flash[NLBP]
1zUFu-aUVW4	AKB48	Halloween Night[NLBP]
lkHlnWFnA0c	AKB48	Heavy Rotation[NLBP]
fj6iDHciEmA	AKB48	High Tension (Hyper)[NLBP]
IjFaR-qPr0M	AKB48	Ja-Ba-Ja[NLBP]
ZvNViwHjSa8	AKB48	Jiwaru DAYS[NLBP]
iyn5uirg2j8	AKB48	Juunen Zakura[NLBP]
fgESmgZ4ld8	AKB48	Kaze wa Fuiteiru[NLBP]
eWnLRboP6LI	AKB48	Kibouteki Refrain[NLBP]
JLeFZZaUeaQ	AKB48	Kimi no Hohoemi wo Yume ni Miru[NLBP]
PjgyH3lVI18	AKB48	Kimi no Kotoga Suki Dakara[NLBP]
Q2E7TLotcko	AKB48	Kimi wa Melody[NLBP]
dFf4AgBNR1E	AKB48	Koi suru Fortune Cookie[NLBP]
hfnCAjE8LsU	AKB48	Kuchibiru ni Be My Baby[NLBP]
tzdhDr4t84I	AKB48	Labrador Retriever[NLBP]
GRFwFjgDmus	AKB48	Lucky Seven[NLBP]
n24zp_wPC7E	AKB48	Mae shika mukanē[NLBP]
MBuJ5R2KBKo	AKB48	Manatsu no Sounds Good![NLBP]
qJ-Drv9tVjI	AKB48	Maybe[NLBP]
pKQlKygAMrg	AKB48	Namida surprise![NLBP]
yMb0BLDlOwo	AKB48	NO WAY MAN[NLBP]
8NzfdEyo7x4	AKB48	Nusumareta Kuchibiru[NLBP]
F32epua9VQs	AKB48	Oogoe Diamond[NLBP]
SwXtaahxjls	AKB48	Ponytail to Shushu[NLBP]
bQqLKCg-UgA	AKB48	RIVER[NLBP]
UCasRhwFlBo	AKB48	Sakura no hanabiratachi 2008 [NLN]
n9hNT5ezcnc	AKB48	Sakura No Ki Ni Narou[NLBP]
lhEK1mxOm-I	AKB48	Sakura no Shiori[NLBP]
-jQtbbeWro8	AKB48	Sayonara Crawl[NLBP]
sIgawh0g-PI	AKB48	Shoot Sign[NLBP]
eZ4jYWQh7tE	AKB48	So long ![NLBP]
7DwAwNNHaW8	AKB48	Teacher Teacher[NLBP]
bUCoMByWzI0	AKB48	Tobenai Agehachou[NLBP]
-7YJkt-4R1A	AKB48	Uekara Mariko[NLBP]
ti-uofokNvA	AKB48	Watashi Datte Idol! Short ver.〈Rino Sashihara〉[NLBP]
pizw3Wf8MHM	AKB48	Yasai Sisters[NLBP]
zdgemowocu8	BNK48	Aitakatta[NLBP]
iByxlVvWrww	BNK48	Kimi wa Melody[NLBP]
mfqJyKm20Z4	BNK48	Koisuru Fortune Cookie[NLBP]
IMx1ojx2fiE	BNK48	Shonichi[NLBP]
zEinLKXD9_w	French Kiss	Kakko warui I love you![NLBP]
NFPLNjxYaeM	French Kiss	Omoidasenai hana[NLBP]
aimBejqsgPY	Hinatazaka46	JOYFUL LOVE[NLBP]
5Ixs0tLmEo0	Hiragana Keyakizaka46	Happy Aura[NLBP]
7PP7B313OJk	Hiragana Keyakizaka46	Ima ni Miteiro[NLBP]
aI20JvHedIs	HKT48	12 Seconds[NLBP]
tSlJDGQKAMA	HKT48	74okubun no 1 no kimi e[NLBP]
HwN0VMFUeqU	HKT48	Gunyatto Magatta[NLBP]
6ScAjS1hmcI	HKT48	Hatsukoi Butterfly[NLBP]
4gMAun5RyZA	HKT48	Hayaokuri Calendar[NLBP]
zeNAMx0258w	HKT48	Hikaeme I love you ![NLBP]
wSRkRHPLykM	HKT48	Hitsuzenteki Koibito[NLBP]
I8UgKZQadS4	HKT48	Ishi[NLBP]
YkDyX5S37rE	HKT48	Kiss wa Matsushikanai no Deshouka?[NLBP]
y5jHsV7hCHY	HKT48	Melon Juice[NLBP]
CGXwRIcnrJo	HKT48	Saikou Kayo[NLBP]
4-gTfa2hO0o	HKT48	Sakura, Minna de Tabeta[NLBP]
BDBvkY4BWe0	HKT48	Sakuranbo wo Musuberuka?[NLBP]
-uNVmrDxPXM	HKT48	Sedikit Saja I Love You![NLTP]
SUjvUN0vztY	HKT48	Suki! Suki! Skip![NLBP]
orrJqofVbEI	HKT48	Tonari no Karewa Kakkoyoku Mieru[NLBP]
edRWNE0DIKg	HKT48	Watashi no furusato[NLTP]
-ubel_eLXxU	HKT48 feat. Kishidan	Shekarashika![NLBP]
zoOiWFT0dVE	Keyakizaka46	Ambivalent[NLBP]
Rk5_LDmb1jI	Keyakizaka46	Ambivalent[NLTP]
5b0qb4RoS8U	Keyakizaka46	Fukyouwaon[NLTP]
th20TixA_Ws	Keyakizaka46	Futari Saison[NLTP]
VF2nSitbit4	Keyakizaka46	Garasu Wo Ware![NLBP]
ylG74t_iPL8	Keyakizaka46	Hiraishin[NLBP]
DnrgxgB464U	Keyakizaka46	Kazenifukaretemo[NLBP]
5b9Z2uLiAWw	Keyakizaka46	Kitaishiteinaijibun[NLBP]
D2QEluvPRiE	Keyakizaka46	Kuroi Hitsuji[NLBP]
6o6Qr4bzQNg	Keyakizaka46	Kuroi Hitsuji[NLTP]
awGVuRoxrkw	Keyakizaka46	Sekainiwa Aishikanai[NLBP]
uxRi5CuOJx8	Keyakizaka46	Sekainiwa Aishikanai [NLBT]
uDaKPPmDSIE	Keyakizaka46	Silent Majority[NLBP]
w6ABMtg_nsU	Keyakizaka46	Silent Majority[NLTP]
HwM3sqaLpfI	MAEDA Atsuko	Ｆｌｏｗｅｒ[NLBP]
_YybtAuT4YE	NGT48	Haru wa Dokokara Kurunoka?[NLBP]
Ybu13gst7cs	NGT48	Nanikagairu[NLBP]
n-iXRXpfVTs	NGT48	Seisyun Dokei[NLBP]
h52EITY0YoU	NMB48	Boku datte nai chau yo[NLBP]
ZL4SiM3zfLo	NMB48	Boku wa inai[NLBP]
LCmrBvWhVpI	NMB48	Masaka Singapore[NLBP]
XjuHFHxwvGI	NMB48	Nagiichi[NLBP]
q4FwKFk658c	NMB48	Tokonoma seiza musume[NLBP]
gtIgVyd7TF8	NMB48	Which one[NLBP]
VUfMsIB6sJE	NMB48	Yokubomono[NLBP]
gTqm5fYEbVI	Nogizaka46	Atarashī sekai furu[NLBP]
rhTBOwEnK-Y	Nogizaka46	Girls' Rule[NLBP]
OtzRWcavPwg	Nogizaka46	Guruguru Curtain[NLBP]
0Fpr-eJYbvc	Nogizaka46	Hadashide Summer[NLTP]
uCcm3O-dUOM	Nogizaka46	Harujion ga Sakukoro[NLTP]
lZsl6NYZaj0	Nogizaka46	I Want To Go Home From Afar[NLTP]
Xfp3V3oqQfY	Nogizaka46	Ima, hanashitai dareka ga iru[NLTP]
n6AWrEnzzRc	Nogizaka46	Influencer[NLTP]
h9BGT9ozkqY	Nogizaka46	Inochi wa Utsukushii Kara[NLBP]
oAyK7IhFAV8	Nogizaka46	Itsuka Dekiru Kara Kyou Dekiru[NLTP]
auTe1lvqDkM	Nogizaka46	Jikochu de Ikou![NLTP]
ET9XF4OSo7E	Nogizaka46	Kyūshamen[NLTP]
2uR9a8nRYV8	Nogizaka46	Nandome no Aozora ka? (HTC Butterfly 2)[NLTP]
mZfMSWh58fk	Nogizaka46	Natsuno Free&Easy[NLBP]
Ggv1heiVrdM	Nogizaka46	Seifuku no Mannequin[NLBP]
f0wbnQw89J0	Nogizaka46	Synchronicity[NLBP]
uZfjrnhTT4U	SKE48	1!2!3!4! Yoroshiku![NLBP]
5vtPErasOAU	SKE48	Aozora Kataomoi[NLBP]
50tdxFws5x4	SKE48	Gomenne, SUMMER[SCALE 1.33][NLBP]
Onbgr-dNG-o	SKE48	Ikinari Punch Line[NLBP]
so2ELIW3p48	SKE48	Muishiki no Iro[NLBP]
8TGfJp1hNkA	SKE48	Tsuyoki Mono Yo[NLBP]
WfWU9KuifzM	SNH48	Ponytail to Shushu[NLBP]
asLJiYOf_No	STU48	Kaze o matsu[NLBP]
wTHJ_V96lFQ	STU48	Kurayami[NLBP]
JzHgwRlzZrc	STU48	Setouchi no koe[NLBP]
VP9IrR3Unno	STU48	Shukkō[NLBP]
3A8ReZ_punE	Keyakizaka46	Fukyouwaon[NLBP]
hFM5iFC4B5g	ASIAN KUNG-FU GENERATION	A Town In Blue[NLBP]
J_IsnEZcl4E	ASIAN KUNG-FU GENERATION	After Dark[NLBP]
ZOzfBbjSDKc	ASIAN KUNG-FU GENERATION	Atarashii Sekai[NLBP]
-Lgvvn7u34w	ASIAN KUNG-FU GENERATION	Bicycle Race[NLBP]
gBarcnW_tcQ	ASIAN KUNG-FU GENERATION	Black Out[NLBP]
LIz1rcHwUZk	ASIAN KUNG-FU GENERATION	Blood Circulator[NLBP]
x9nkiTeuYRo	ASIAN KUNG-FU GENERATION	Blue Train[NLBP 250]
oqw00bxN_4w	ASIAN KUNG-FU GENERATION	Boys & Girls[NLBP]
sOVvpT-t5O0	ASIAN KUNG-FU GENERATION	Caterpillar[NLBP]
TY4c5Pboq1I	ASIAN KUNG-FU GENERATION	Circus[NLBP]
mtdQA4b9bH8	ASIAN KUNG-FU GENERATION	Clicking My Heels To Love[NLBP]
OiVWX4MWjDU	ASIAN KUNG-FU GENERATION	Clock Work[NLBP]
d9AHhDhnTss	ASIAN KUNG-FU GENERATION	Dancing Girl[NLBP]
cs7SbkGxi98	ASIAN KUNG-FU GENERATION	Easter[NLBP]
EEYDyXe9K6o	ASIAN KUNG-FU GENERATION	Eternal Sunshine[NLBP]
S4jaM0tD5u8	ASIAN KUNG-FU GENERATION	Fujisawa Loser[NLBP]
c7P0aIcYmbY	ASIAN KUNG-FU GENERATION	Goodbye Soldier[NLBP]
nJ6A6GC_ki4	ASIAN KUNG-FU GENERATION	Haruka Kanata (Far And Beyond)[NLBP]
RhuxGeq4ycw	ASIAN KUNG-FU GENERATION	Hometown[NLBP]
0TWpmLskS6U	ASIAN KUNG-FU GENERATION	Kimitoiuhana -A Flower Named You-[NLBP]
KGM-BO0mklY	ASIAN KUNG-FU GENERATION	Kouya Wo Aruke[NLBP]
azbxuqzDBHU	ASIAN KUNG-FU GENERATION	Little Lennon[NLBP]
qw0mqFhL6sM	ASIAN KUNG-FU GENERATION	Living in the Now[NLBP]
F4l9qxtTbmM	ASIAN KUNG-FU GENERATION	Loop&Loop[NLBP]
-BF1PPQ7rHo	ASIAN KUNG-FU GENERATION	Love Song of New Century[NLBP]
kplNQAJpjx4	ASIAN KUNG-FU GENERATION	Maigo inu to Ame no beat[NLBP]
GSQk5QFYEZk	ASIAN KUNG-FU GENERATION	Marching Band[NLBP]
l97dEKz0XkM	ASIAN KUNG-FU GENERATION	Memories of the Ruins[NLBP]
I8SHPIf49mk	ASIAN KUNG-FU GENERATION	Mirainokakera -Piece of the Future-[NLBP 250]
2qMgVI_dSUI	ASIAN KUNG-FU GENERATION	Motor Pool[NLBP]
5bZ53Ynus1Y	ASIAN KUNG-FU GENERATION	Mustang[NLBP]
EphAW4o9-HQ	ASIAN KUNG-FU GENERATION	Opera Glasses[NLBP]
Jn84xngr3Zc	ASIAN KUNG-FU GENERATION	Planet of the Apes[NLBP]
dJn9wLhJe1A	ASIAN KUNG-FU GENERATION	Prisoner in a Frame[NLBP]
UfkZFwexZ6o	ASIAN KUNG-FU GENERATION	Rainbow Flag[NLBP]
-AbZTFS3DAw	ASIAN KUNG-FU GENERATION	Re:Re: (Single ver.)[NLBP]
vyM4h4iVeFo	ASIAN KUNG-FU GENERATION	Re:Re:[SCALE 1.04][NLBP]
ZmeudwRMrsU	ASIAN KUNG-FU GENERATION	Rewrite[NLBP]
IkyiAMO8U3I	ASIAN KUNG-FU GENERATION	Right Now (Short Version)[NLBP]
rDTFSD9K9dA	ASIAN KUNG-FU GENERATION	Rock'n Roll, Morning Light Falls on You[NLBP]
CVmLs1NtBnI	ASIAN KUNG-FU GENERATION	Rolling Stone[NLBP]
pqBaR-cFRco	ASIAN KUNG-FU GENERATION	Signal on the Street[NLBP]
X8YKWrN-kJA	ASIAN KUNG-FU GENERATION	Sleep (Short Version)[NLBP]
xZD1B1TskXs	ASIAN KUNG-FU GENERATION	Soranin[NLBP]
gWKZ9E9piXI	ASIAN KUNG-FU GENERATION	Soredewa, Mata Ashita (Well Then, See You Again Tomorrow)[NLBP]
tVeOTxoX4R4	ASIAN KUNG-FU GENERATION	Standard[NLBP]
saDaTwK9Mz4	ASIAN KUNG-FU GENERATION	The Survivor's March[NLBP]
oKO-KREPjUM	ASIAN KUNG-FU GENERATION	To Your Town[NLBP 250]
LEdhbnbY3z8	ASIAN KUNG-FU GENERATION	UCLA[NLBP]
-kyifbl3QSc	ASIAN KUNG-FU GENERATION	Winner and Loser[NLBP]
AriD_U5-lZ8	ASIAN KUNG-FU GENERATION	Wonder Future[NLBP]
A5egJFoAFZs	ASIAN KUNG-FU GENERATION	World World World[NLBP]
jlqTeCQehOs	BOOM BOOM SATELLITES	A HUNDRED SUNS[NLBP]
4ufdfaQ4ocE	BOOM BOOM SATELLITES	Another Perfect Day[NLBP]
N8BgpXJ6YLY	BOOM BOOM SATELLITES	ANOTHER PERFECT DAY[NLBP]
SpT5PXTgQHo	BOOM BOOM SATELLITES	BACK ON MY FEET[NLBP]
ZtVNg6TFyq0	BOOM BOOM SATELLITES	BLINK[SCALE 1.33][NLBP]
oqSIIYFTRpE	BOOM BOOM SATELLITES	Broken Mirror[NLBP]
ByovzaAf9dM	BOOM BOOM SATELLITES	Disconnected[NLBP]
d0KrE0F9n_I	BOOM BOOM SATELLITES	DIVE FOR YOU[SCALE 1.19][NLBP]
-idaWb77ygY	BOOM BOOM SATELLITES	DRAIN[NLBP]
EygDjTMWvXo	BOOM BOOM SATELLITES	Drifter[NLBP]
6wHJth6CgSw	BOOM BOOM SATELLITES	Embrace[NLBP]
3GFc8PwHIIU	BOOM BOOM SATELLITES	Flutter[NLBP]
e6hLINW-vxQ	BOOM BOOM SATELLITES	GIRL[NLBP]
hOuoWjJtX00	BOOM BOOM SATELLITES	INTERGALACTIC[SCALE 1.19][NLBP]
Wbb2MsD56JY	BOOM BOOM SATELLITES	JOYRIDE[SCALE 1.19][NLBP]
56KV6q9CH_4	BOOM BOOM SATELLITES	KICK IT OUT[NLBP]
Krem4GHmmxg	BOOM BOOM SATELLITES	LAY YOUR HANDS ON ME (Short version)[NLBP]
5X9mrJVHbJU	BOOM BOOM SATELLITES	LAY YOUR HANDS ON ME[NLBP]
G4Kj4l0xIGU	BOOM BOOM SATELLITES	MOMENT I COUNT[NLBP]
mMY4ATeviCM	BOOM BOOM SATELLITES	NINE[NLBP]
Q30vHwINt_4	BOOM BOOM SATELLITES	ONENESS[NLBP]
E5y3-9xqmwo	BOOM BOOM SATELLITES	ONLY BLOOD[NLBP]
LDmpnXssW0Y	BOOM BOOM SATELLITES	PILL[SCALE 1.19][NLBP]
Yp0_q4Tb7c8	BOOM BOOM SATELLITES	PUSH EJECT[NLBP]
VObVB69daOA	BOOM BOOM SATELLITES	Shut Up and Explode[NLBP]
_hjcbqndlfY	BOOM BOOM SATELLITES	Snow[NLBP]
jmk9W8DQqZE	BOOM BOOM SATELLITES	SOLILOQUY[NLBP]
4QVOMarlD6w	BOOM BOOM SATELLITES	SPINE[SCALE 1.19][NLBP]
kggYoiwRScM	BOOM BOOM SATELLITES	Stars and Clouds[NLBP]
IWkU1kT_vkw	BOOM BOOM SATELLITES	WHAT GOES ROUND COMES AROUND[SCALE 1.19][NLBP]
LZ6-PfPx0EM	CAPSULE	Another World[NLBP]
q7dvB3shNgk	CAPSULE	Candy Cutie[NLTP 250]
A2sFSiaS65E	CAPSULE	Control[NLBP]
ZRf-GSen3to	CAPSULE	Cosmic Tone Cooking[NLBP]
LsgmVWUPChs	CAPSULE	e.d.i.t.[NLBP]
eTVVyqoUpK8	CAPSULE	Feelin' Alright[NLTP]
Sms0CTBm8zY	CAPSULE	Glider[NLBP]
uzAjefDUpj0	CAPSULE	Hanabi[NLBP]
PqdcAoMylWI	CAPSULE	I'm Feeling You[NLBP]
GGuE-Se1Rx0	CAPSULE	Idol Fancy[SCALE 1.33][NLBP]
iWYrfIVLcpI	CAPSULE	Jelly[NLBP 250]
viycVSrrCXk	CAPSULE	Jumper[NLBP]
GKML3z0VZb4	CAPSULE	Love or Lies[NLBP 250]
MxXzLphD6dk	CAPSULE	Music Controller[SCALE 1.33][NLBP]
NmpZoTBh6Xk	CAPSULE	MUSiXXX[NLBP]
FnwSbVM6E7k	CAPSULE	Plastic Girl[SCALE 1.33][NLBP]
CYXJOhL958g	CAPSULE	Portable Airport[NLBP]
twpRI67QHLU	CAPSULE	Prime Time[NLBP]
0R446pAo29s	CAPSULE	Retro Memory[NLBP 250]
UqTdgyHetz8	CAPSULE	Sakura[NLBP 200]
obzjOijoVyA	CAPSULE	Soratobu Toshikeikaku[NLBP 425]
4DllmtTT7Q0	CAPSULE	Space Station N°9[NLBP]
vW9DUn4ZIOU	CAPSULE	Starry Sky[NLBP]
Xi12ciJNBmA	CAPSULE	Stay With You[NLBP]
mvirM9odOJo	CAPSULE	Step On The Floor[NLBP]
x6UurRhIgD0	CAPSULE	Sugarless GiRL[NLBP]
lhYZXmtLAJA	CAPSULE	Tokyo Kissa[NLBP]
W4h8m74pyC8	CAPSULE	World Of Fantasy[NLBP]
eb_lznby0bk	amazarashi	Christmas[NLBP]
BZE9C2iAi0A	amazarashi	Ending Theme[NLBP]
reT9WOAgK_w	amazarashi	Hero[NLBP]
Fv7ldgocZRs	amazarashi	Jigyaku-ka no arī[NLBP]
Upvuj6GhAa4	amazarashi	Kisetsuhatsugitsugishindeiku[NLBP]
fodRoRdDSug	amazarashi	Monday[NLBP]
XHNZbhb-yTw	amazarashi	seizensetsu[NLBP]
-j4LVcY7_zc	amazarashi	Sora Ni Utaeba[NLBP]
hLbnv6TI30Q	amazarashi	Tarareba[NLBP]
KWLYf5DVW8U	Charisma.com	Kongara Girl[NLBP]
4ZdZJMb2-Lo	Charisma.com	Otubone Rock[NLBP]
9dfKJ503-Fc	GARNiDELiA	Aikotoba[NLBP]
K42ED-7PWAo	GARNiDELiA	ambiguous[NLBP]
74q5yvpZAos	GARNiDELiA	Blazing[NLBP]
9Omg-kRwcw8	GARNiDELiA	Cry[NLBP]
JQAl_bQVOBs	GARNiDELiA	Désir[NLBP]
YqZfJRu-_zY	GARNiDELiA	Error[NLBP]
BEULybZnLO8	GARNiDELiA	Gokuraku Jodo[NLBP]
hUf1NoPK-8Q	GARNiDELiA	Grilletto[NLBP]
nziMTeijTZw	GARNiDELiA	Mirai[NLBP]
wyZOIg7ckzQ	GARNiDELiA	Pride[NLBP]
GQlky845kk8	GARNiDELiA	Speed Star[NLBP]
VaUvLnruYzQ	GARNiDELiA	Yakusoku[NLBP]
wNNnMGMiQ94	HALCALI	Endless Night[SCALE 1.33][NLBP]
RR5buVd6w0M	HALCALI	It's PARTY TIME[NLBP 250]
ux7i6XNztRI	HALCALI	LIghts, Camera, Action![NLBP]
DXq_5eukLF8	HALCALI	Long Kiss Goodbye[SCALE 1.33][NLBP]
uM2cyQUIw9Q	HALCALI	Look[NLBP 250]
gh91p8qQWNI	HALCALI	Roman Hikou[SCALE 1.33][NLBP]
TekJBDqA55Y	HALCALI	Yes[NLBP]
sQbAzXHyOfk	Aural Vampire	Cannibal coast[SCALE 1.33][NLBP]
BlKnHOs8RWE	Aural Vampire	Carpe Noctem[NLBP]
px0MwxZ_iEU	Aural Vampire	Freeeeze!![NLBP 250]
IXplD4VwkLo	Aural Vampire	Vampire Ecstasy[NLBP 250]
B-A2eYlbrwQ	DECO*27 feat. GUMI	Yowamushi Mont Blanc[NLBP 250]
mcczsWj6ofE	Genki Rockets	Breeze[SCALE 1.33][NLBP]
n-rpz6ONidM	Genki Rockets	Curiosity[NLBP]
liMZLfqBgRE	Genki Rockets	Flow[NLBP]
aW8uGXlyF9U	Genki Rockets	Heavenly Star [NLJMO][NLBP]
EGTmWCU-BFA	Genki Rockets	Make believe[NLBP]
OvGHZ_nctm0	Genki Rockets	Revive[NLBP]
NFgVvMK4EfU	Genki Rockets	Star Line[NLBP]
5hHTPgA9X1Q	Genki Rockets	Star Surfer[NLBP]
-aeq8h2D7B0	Genki Rockets	Touch me[NLTP]
BWV_UkEcBmI	Genki Rockets	Wonderland[NLBP]
4cT5w2O6Eqg	i-dep	believe [NLIN][SCALE 1.33][NLBP]
HJb0394et0Y	Jean Jacques Perrey	Mary France[NLBP]
S8dmq5YIUoc	Kizuna AI feat. Nakata Yasutaka	AIAIAI[NLBP]
UoK8DaJRDaM	KYARY PAMYU PAMYU	CANDY CANDY[NLBP]
2bJ49dOSP9o	KYARY PAMYU PAMYU	Crazy Party Night-Pumpkins Strike Back[NLBP]
6OSiE4I-tRY	KYARY PAMYU PAMYU	Easta[NLBP]
paHGjIe2Wms	KYARY PAMYU PAMYU	Family Party[NLBP]
GivkxpAVVC4	KYARY PAMYU PAMYU	Fashion Monster[NLBP]
9Y6H-YjsE9Q	KYARY PAMYU PAMYU	furisodeshon[NLBP]
mAGyQ5Rmz7o	KYARY PAMYU PAMYU	HARAJUKU IYAHOI[NLBP]
TWxrIblJHO0	KYARY PAMYU PAMYU	Kimino Mikata[NLBP]
eryOLPafXNc	KYARY PAMYU PAMYU	Kira Kira Killer[NLTP]
teMdjJ3w9iM	KYARY PAMYU PAMYU	ninja ri bang bang[NLBP]
yzC4hFK5P3g	KYARY PAMYU PAMYU	PONPONPON[NLBP]
eDh2Lg3RmAM	KYARY PAMYU PAMYU	Ring a Bell[NLBP]
NLy4cvRx7Vc	KYARY PAMYU PAMYU	Tsukematsukeru[NLBP]
nwWm3om-gSw	KYARY PAMYU PAMYU	Yume no Hajima Ring Ring[NLBP]
ry5_DxAX40A	spoon+	Aimai Beibi[NLBP]
nmxdV2WC_l4	spoon+	Chameleon[NLBP]
SWI5Lw3FiYc	spoon+	Hotto Miruku[NLBP]
NahUCKYoZ1A	spoon+	Ichigo on short cake[NLBP]
DvKxgCWXKbg	spoon+	Jōtōna memai[NLBP]
xlY3-5Lpv4E	spoon+	Kanfūgāru[NLBP]
RbjMlbEkC1c	spoon+	Kurōzetto jikan[NLBP]
xhmCwChhU80	spoon+	merry marie[NLBP]
zcyn6fx1_cs	spoon+	Night diver[NLBP]
h0z0sPH-NRc	spoon+	Poppidu (shortVer.)[NLBP]
9N8vl4yzP2Y	spoon+	shine UP[NLBP]
KKDiU_Fjb5g	Wadey Nara VS Genki rockets	C'EST EN TOI (heavenly star)[SCALE 1.33][NLBP]
syLz1rcTKD8	Wednesday's Campanella	Jeanne d'Arc[NLBP]
zlK5abIJRyM	WORLD ORDER	2012[NLBP]
MMSjOVkkQiE	WORLD ORDER	AQUARIUS[SCALE 1.33][NLBP]
iQ4AeAFdlSM	WORLD ORDER	BIG BROTHER[NLBP]
35hCo_grAqw	WORLD ORDER	BOY MEETS GIRL[NLBP]
wuvoCVCAX9k	WORLD ORDER	CHANGE YOUR LIFE[NLBP]
-hm8QfWwq7U	WORLD ORDER	FIND THE LIGHT IN THAILAND[NLBP]
_mkiGMtbrPM	WORLD ORDER	HAVE A NICE DAY[NLBP]
Tblx00nIZB0	WORLD ORDER	IMPERIALISM[NLBP]
aSqwmZH33CQ	WORLD ORDER	INFORMAL EMPIRE[NLBP]
wkwTPPDNawA	WORLD ORDER	LAST DANCE[NLBP]
FMrqlo_L-gY	WORLD ORDER	Let's start WW3[NLBP]
r-qhj3sJ5qs	WORLD ORDER	MACHINE CIVILIZATION[NLBP]
4ua64HbsBUo	WORLD ORDER	Mind Shift[NLBP]
QoNx1P6nMoU	WORLD ORDER	MISSING BEAUTY[NLBP]
0vXbK3g7cM8	WORLD ORDER	MULTIPOLARITY[NLBP]
xwg2Hpf4ta8	WORLD ORDER	PERMANENT REVOLUTION[NLBP]
N9JtUC8hl8o	WORLD ORDER	QUIET HAPPINESS[NLBP]
kl_kyhwCDtY	WORLD ORDER	SINGULARITY[NLBP]
vH0pSHZOsTk	WORLD ORDER	THE NEXT PHASE[NLBP]
mCdoCFI-ILg	WORLD ORDER	THIS IS LIFE[NLBP]
IDAlZ7PDMDU	WORLD ORDER	Welcome to TOKYO[NLBP]
nDOPNLzEFH0	WORLD ORDER	WORLD ORDER A NEW YORK[NLBP]
JV3eoboDv2g	Yasutaka Nakata feat. Charli XCX & Kyary Pamyu Pamyu	Crazy Crazy[NLBP]
BZbmbITB54M	ZETTAI × BREAK !!	Twinkle Rhythm[NLTP]
n4Y6n7HIwqw	Camellia Factory	"Trolls: Sing Dance Hug!" Ending Song[NLBP]
P--IjSQfhlE	Camellia Factory	“The myth of 3rd date”[NLTP]
kTCgEAmrmh4	Camellia Factory	A Spring Love Song[NLTP]
WlFZP6_E5Ak	Camellia Factory	Blossom With Elegance![NLTP]
jM3gyGYdCKg	Camellia Factory	Country Girls[NLTP]
slXI0APjhyY	Camellia Factory	First Love Sunrise[NLTP]
yP9adC2yB5U	Camellia Factory	I Need You ~The Ferris Wheel in the Night Sky~[NLTP]
zLpHLcsSIik	Camellia Factory	Job hunting sensation[NLTP]
v4SCOUBKuOc	Camellia Factory	Junjou cm[NLTP]
fuX3wt_JyHg	Camellia Factory	Just Try![NLTP]
_tnzf00cGDo	Camellia Factory	Keeping You All to Myself[NLTP]
KYRnRFD3EY8	Camellia Factory	Low Temperature Burn[NLTP]
64evz2g7SWo	Camellia Factory	Onadate, I’dliketoshoweratleasttwiceandgo[NLTP]
E8Y7QBhU6Co	Camellia Factory	Only for tonight, I wanted to be playful[NLTP]
EtlNSncRMjk	Camellia Factory	Smile[NLTP]
WbQdpVPT-VQ	Camellia Factory	Softly, the clock of love.[NLTP]
vSxfMVMk8dQ	Camellia Factory	The Cabbage Statement ~ Spring Version[NLTP]
_jAi4vCmFR8	Camellia Factory	The Flower Pattern[NLTP]
rt6WWKYNDMI	Camellia Factory	The Magnificent Camellia[NLTP]
Mo6IhS3nAK8	Magnolia Factory	A song of ramen loving girl Ms.Koizumi[NLTP]
960j3j-XR4g	Magnolia Factory	Be Double Sure (with ”NEN” Ver.)[NLTP]
s2XR65k3ptc	Magnolia Factory	Cherry Blossom Night Fever[NLTP]
mh7kpsslCPQ	Magnolia Factory	Dosukoi! Humble but Bold[NLTP]
GPFwLgz_Tz4	Magnolia Factory	Foolishly Honest! Impulsive Actions![NLTP]
cRmOd0a1TAw	Magnolia Factory	Haru Urara Beautiful Spring[NLTP]
UtjqUqT_uiQ	Magnolia Factory	Hey Youth, Come At Me![NLTP]
bn_2v0XaON0	Magnolia Factory	I must be…[NLTP]
PaEO76PJoyM	Magnolia Factory	I’m such a popular kid[NLTP]
HqCDuKgukB4	Magnolia Factory	Let it be a fine day tomorrow[NLTP]
Sw2lygzl0hU	Magnolia Factory	Oh No The Torment[NLTP]
sRnDU6GQpvk	Magnolia Factory	Osu! Soul of Kobushi[NLTP]
iw8r6jjtc2Y	Magnolia Factory	Samba! Kobushi Janeiro[NLTP]
NxKG38lPzUQ	Magnolia Factory	Sha la la! we can do this![NLTP]
kMNLkGUBMBM	Magnolia Factory	Starts from now![NLTP]
8S-YIkMrQAE	Magnolia Factory	The Kobushi Magnolia Flower[NLTP]
C4TcG1-45f0	Magnolia Factory	Where there is a will, there is a way.[NLTP]
5uzhmm_oUZU	℃-ute	Adam to Eve no Dilemma[NLTP]
rYn1HGDwIIY	℃-ute	Aitai aitai aitai na[NLBP]
2DhZ_1bETkg	℃-ute	Aitai Lonely Christmas[NLBP]
SPnsmgUGQ70	℃-ute	Bye Bye Bye![NLBP]
mSyHnddLb30	℃-ute	Campus Life (Umarete Kite Yokatta)[NLBP]
UBmBGKjFuRQ	℃-ute	Dreamlike Climax[NLTP]
Hl7WGQhRPMI	℃-ute	Edo no Temari Uta II[NLBP]
JquSlg7zqVE	℃-ute	FOREVER LOVE[NLBP]
jsQKc6Q5mGc	℃-ute	Gamusha LIFE[NLTP]
9kuZ2mDiKOs	℃-ute	I miss you[NLTP]
4l_jiJu4Lfg	℃-ute	Kiss me Itoshi teru[NLBP]
EMp4DS64zTE	℃-ute	Kono machi[NLBP]
z1zjviWR2XQ	℃-ute	LALALA Shiawasenouta[SCALE 1.33][NLBP]
Y3k0x2dO-Pg	℃-ute	Living alone in the city[NLTP]
L9gDX4mfWtY	℃-ute	Massara Blue Jeans[NLBP 250]
sdjaLQudcqw	℃-ute	Ookina Ai de Motenashite[NLBP]
WhVW7RLuCkE	℃-ute	Sekaiichi Happy na Onna no Ko[NLBP]
TTPzTYYHORE	℃-ute	Shochū o mima i mōshi age masu[NLBP]
Z5jkdriuMjs	℃-ute	SHOCK！[NLBP]
fCngbRuBD6I	℃-ute	Summer Wind[NLBP]
n_K8bSpDw9U	℃-ute	The Curtain Rises[NLTP]
EmrvcbU3jsY	℃-ute	The Grieving Heaven[NLTP]
iIyc4LTOmP8	℃-ute	The Middle Management[NLTP]
iFz2PVuUess	℃-ute	The Power[NLTP]
jG3S3BnxaR8	℃-ute	To Tomorrow[NLTP]
m_eZzjfYei8	℃-ute	Turn the Next Corner[NLTP]
njCe2i91kWo	ANGERME	4.6 Billion Years Love[NLTP]
eBQcrpsJfMI	ANGERME	A Complete Turnover[NLTP]
GI42r4sJx7k	ANGERME	A Girl's Counterattack (Dance Shot Ver.)[NLTP]
KCQT4STlXz0	ANGERME	A Late Bloomer[NLTP]
BJk0PxPUfb8	ANGERME	Dreamed for 15 years[NLTP]
6VkIMbCT3SA	ANGERME	Every man to his taste. (Like it!)[NLTP]
eAtypTNHe48	ANGERME	I Can't Cry… The Fraud of Empathy[NLTP]
bbDcPZeb7pY	ANGERME	I don’t need anything but love.[NLTP]
IL-VnIPyeO0	ANGERME	I’ll Forget Everything For You[NLTP]
9PgpgVf6GLQ	ANGERME	Itoshima Distance[NLTP]
77QezZxgA6s	ANGERME	Love is Accha Accha[NLTP]
Ofw6MQVvgOg	ANGERME	Meg The Little Witch[NLTP]
PdgtxpNv6mw	ANGERME	One by One, One after Another[NLTP]
K70cGmwHYEE	ANGERME	saki ichirouta[NLBP]
dFvM_XSFr8U	ANGERME	Sally the Witch[NLTP]
fiV6VoZwPvU	ANGERME	Tear Colored Decision[NLTP]
hCfwA8U87QM	ANGERME	Ups and Downs[NLTP]
Y60lZ3EUJns	ANGERME	Uraha=Lover[NLTP]
aajn35ZQT5M	Berryz Kōbō	130 million Diet minded Country (Dance Shot Ver.)[NLTP]
C9hVxOVtbxk	Berryz Kōbō	Asian Celebration[NLBP]
BQ_7F3axw_E	Berryz Kōbō	cha cha SING[NLBP]
sGoBpGmjow8	Berryz Kōbō	Faitingupōzu wa Date janai![NLBP]
pL2WMSk_sEw	Berryz Kōbō	Genghis Khan[NLBP 250]
40eQBJRvCk8	Berryz Kōbō	Happiness ~ kōfukukangei!~[NLBP 250]
ORjHxuhhZCY	Berryz Kōbō	Jiriri kiteru[NLBP]
Rr9fr5VZgDQ	Berryz Kōbō	Koinojubaku[NLBP]
PFmeufAaxCA	Berryz Kōbō	Love is Always inside you (Dance Shot Ver.)[NLTP]
IF9AgZevL2g	Berryz Kōbō	Loving you Too much[NLBP]
6dl3HMYRFFI	Berryz Kōbō	Maji Bomber!![NLBP]
hOwaifd4_hw	Berryz Kōbō	Piriri to Yukō![NLBP]
f2j1UtCQ1zc	Berryz Kōbō	Speaking of Romance (Dance Shot Ver.)[NLTP]
gl23DgzqPZk	Berryz Kōbō	Waratchaou yo BOYFRIEND[NLBP]
3U_3D9emRUg	Buono!	Bravo☆Bravo[NLBP]
zXPs4ZW3tSM	Buono!	co・no・mi・chi[NLBP]
0W-aBo6RPjk	Buono!	Gachinko de Ikō![NLBP]
CgO1WEDGZuM	Buono!	Honto no Jibun[NLBP]
sBneab6okdY	Buono!	JUICY HEART[NLBP]
zyLGwWTVlcc	Buono!	Kiss!Kiss!Kiss![NLBP]
GcZckEcCryI	Buono!	Kokoro no tamago (dance shot)[NLBP]
7BAnHEUCaQg	Buono!	MY BOY[NLBP]
jDB0r2E0m4k	Buono!	Natsu Dakara![NLBP]
bx2ZVEE0Xj4	Buono!	Never gonna stop![NLBP]
ptdJYBDxMxg	Buono!	Our Songs[NLBP]
d8Kb0WD8kvE	Buono!	Ren'ai Rider[NLBP]
BZhQoY37qQ4	Buono!	Renai ♥ Rider[NLBP]
aWmKgNZUkqQ	Buono!	Rottara Rottara[NLBP]
9gg48-ux4is	Buono!	So La Si Do ~Nee Nee~ (Close up Ver)[NLBP]
cGR7AIgSQlc	Buono!	So La Ti Do ~Hey, Hey~[NLBP]
J1u_1VvDrA8	Buono!	Take It Easy![NLBP]
qzcktJ2gi6w	Buono!	Zassō no Uta[NLBP]
wT28y_i78hs	Country Girls	Boogie Woogie LOVE[NLTP]
CaPsoSJ3qnI	Country Girls	Hesitating Summer Time[NLTP]
ZB0JUi5aCtg	Country Girls	I Don’t Really Care[NLBP]
C7TgAVcvB9k	Country Girls	I Don’t Really Care[NLTP]
SdogeGsDHw4	Country Girls	I know but I'm sorry[NLTP]
ec0xLC70Z4Y	Country Girls	Love is a Magnet[NLTP]
o7x3dC1ZbtE	Country Girls	Love Thief[NLTP]
5k9cmZLKdaQ	Country Girls	Peanut Butter Jelly Love[NLTP]
yb19As-pFNU	Country Girls	Ran Ra Run ~crazy about you~[NLTP]
nHeUWB8qnZ0	Country Girls	Request of Tears[NLTP]
L6ddlZ1BxIo	DIY♡	Fore Fore ～Forest For Rest～[NLBP]
behGDIRH_8A	Hello! Pro Egg feat. Juice=Juice	Go up higher![NLTP]
SgEl8y1hxHU	Juice=Juice	“I’ll DoItTomorrow”AretheWordsofaBuffoon[NLTP]
8iLP7hz-UxY	Juice=Juice	Black Butterfly (Dance Shot Ver.)[NLTP]
ROeoeYQ33hM	Juice=Juice	Black Butterfly[NLTP]
iDNexQ6aWCk	Juice=Juice	Blown by the Wind (Dance Shot Ver.)[NLTP]
pem60iEtcGQ	Juice=Juice	Blown by the Wind[NLTP]
xwSTKrvxfLU	Juice=Juice	Ça va ? Ça va ? (Dance Shot Ver.)[NLTP]
XsnxU8QwJwI	Juice=Juice	Ça va ? Ça va ?[NLTP]
XBQ0v95I9RE	Juice=Juice	CHOICE & CHANCE[NLTP]
LNPHQ0yrkW8	Juice=Juice	Don't be spiteful, but embrace me (KYAST Dance Shot Ver.)[NLTP]
wCNV_wAx82Y	Juice=Juice	Don't be spiteful, but embrace me[NLTP]
EC19AV19rEg	Juice=Juice	Dream Road 〜My Heart is Dancing〜[NLTP]
E2AKITM9uA0	Juice=Juice	Everlasting story[NLTP]
GDE1sB-Uz4s	Juice=Juice	Experiencing the first time (Dance Shot Ver.)[NLTP]
NzxMVYTRg2Q	Juice=Juice	Experiencing the first time[NLTP]
GScVBPWGYBc	Juice=Juice	Feel ! I feel[NLTP]
0SMjNmSwFic	Juice=Juice	Fiesta! Fiesta! (Short Ver.)[NLTP]
pn3Djtkk66k	Juice=Juice	Good bye & Good luck![NLTP]
XusWMlJH178	Juice=Juice	HADAKANO HADAKANO HADAKANO KISS[NLTP]
Sb6keJJznGI	Juice=Juice	Hug me before I ask you to (Dance Shot Ver.)[NLTP]
VEK4N5qatIk	Juice=Juice	Hug me before I ask you to (MEMORIAL EDIT)[NLTP]
cchjirF7zM4	Juice=Juice	Hug me before I ask you to[NLBP]
Fqm6smULwxs	Juice=Juice	I want to do a lot of things![NLTP]
2I1hkkD9s6s	Juice=Juice	It’s okay to cry[NLTP]
HBFvJZR7yKQ	Juice=Juice	Jidanda Dance[NLTP]
JzDQj4X17gI	Juice=Juice	KEEP ON: The Ambition to Succeed!![NLTP]
NtBZEHyB_jo	Juice=Juice	Lightly Sparkling[NLTP]
38c5UbdpfLw	Juice=Juice	My life is not just for show[NLTP]
7sJTyrHGK1k	Juice=Juice	Next is you![NLTP]
rh8eeteWbHc	Juice=Juice	Romance is on its way[NLTP]
SCPzO2c-lMI	Juice=Juice	SA-MI-DA-RE girls It's crazy (MEMORIAL EDIT)[NLTP]
YHrpszUthUM	Juice=Juice	SA-MI-DA-RE girls It's crazy[NLTP]
AgxdaRvQL5Q	Juice=Juice	Sexy Sexy[NLTP]
QOMUp7ODrO8	Juice=Juice	Solitary[NLTP]
_so9w95wzVI	Juice=Juice	Stretching to be a grown up[NLTP]
3FX7TStqkRs	Juice=Juice	Synchro[NLBP]
tj8EFzQZuIk	Juice=Juice	Vivid Midnight[NLTP]
YlkOq6dXBEc	Juice=Juice	Wonderful World[NLTP]
sqkgQUF5wfU	Morning Musume.	"GUNDAN" of the love[NLTP]
rEnzfWtwlxA	Morning Musume.	Ambitious! Yashin-tekide ījan[NLBP]
36imDbY8d3I	Morning Musume.	Aruiteru[NLBP 250]
l7ej9o3o68M	Morning Musume.	Do it! Now[NLBP]
8yDPxXcc9fo	Morning Musume.	Go Girl! ~ Koi no Victory[NLBP]
Dh695gSiwo8	Morning Musume.	Happy summer wedding[NLBP 250]
adKxssyO5iE	Morning Musume.	Help me!![NLBP]
xlijaMeG2Kk	Morning Musume.	Joshi Kashimashi Monogatari[SCALE 1.04][NLBP 250]
ITrHWt6tldc	Morning Musume.	Koko ni iru ze ~e ![NLBP]
NwacTv-6DK4	Morning Musume.	Love Machine[NLBP]
qv0rLpekstQ	Morning Musume.	Manatsu no kōsen[NLBP]
YLBP_NHK3Mo	Morning Musume.	Memory seishun no hikari[NLBP 250]
h7GpSmkRD0o	Morning Musume.	Mikan[NLBP]
WzvwlrLkQIs	Morning Musume.	One・Two・Three (Dance Shot Ver.)[NLBP]
CJRbEZYyKb8	Morning Musume.	Osaka Koi no Uta[NLBP 250]
481q8FTwxZQ	Morning Musume.	Pyoko Pyoko Ultra[NLBP]
wDp4SdacX5U	Morning Musume.	Roman ～MY DEAR BOY～[NLBP]
ItyC0Ipi51I	Morning Musume.	Shabontama[NLBP]
wCPZTjqvN0Q	Morning Musume.'14	Beyond the time and space[NLTP]
7dnHOHXc8pY	Morning Musume.'14	No One Can Replace You[NLTP]
dZ-wMDyXDh4	Morning Musume.'14	TIKI BUN[NLTP]
RKYgWHSN7fM	Morning Musume.'14	What is LOVE?[NLTP]
fcQMPbbq_Fs	Morning Musume.'14	You bright smile is like the sunshine[NLTP]
GtboKJ4D8zg	Morning Musume.'15	An Adolescent Boy is Crying[NLTP]
Vlg0xgl3wTw	Morning Musume.'15	ENDLESS SKY[NLTP]
8RX_cXqYQ8Q	Morning Musume.'15	The Cold Wind and Lonely Love[NLTP]
SRUrbi7xeaU	Morning Musume.'15	The Sunset After the Rain[NLTP]
IiV-aaLo9SM	Morning Musume.'16	Ephemeral Saturday Night[NLTP]
-Hu2tn-Ylgo	Morning Musume.'16	In a corner of a city called Tokyo[NLTP]
RS0QHDdXvCw	Morning Musume.'16	The Vision[NLTP]
2Z-3jHbbcZU	Morning Musume.'17	BRAND NEW MORNING[NLTP]
0JzR89gMSK0	Morning Musume.'17	Don’t Bother Me, Here We Go![NLTP]
51FbTQ1DUWM	Morning Musume.'17	Morning Miso Soup[NLTP]
SQmLjcLfVbo	Morning Musume.'17	You’re Young Anyway![NLTP]
KeWmeqmtOiQ	Morning Musume.'18	A gonna[NLTP]
DGKGT91D9dI	Morning Musume.'18	Are you Happy?[NLTP]
CO3orpe6140	Morning Musume.'18	Because It’s a Free Country.[NLTP]
_uG3Z3hMLj0	Morning Musume.'18	Casually wandering about Ginza[NLTP]
dzKA5w9B6x0	Morning Musume.'19	I surrender. It’s only love but it is love.[NLTP]
wRdYht1IBnM	Peaberry	Cabbage hakusho[NLTP]
OLGcS_ngf7s	Smileage	Do you get it? (Dance Shot Ver.)[NLTP]
uhUFrJSDqrU	Smileage	Dot Bikini[NLBP]
khFjQDiCKE4	Smileage	Koi ni Booing Boo![NLBP]
iqKryI3Sl4U	Smileage	LOVE[NLBP]
2V1Z5vFv8JM	Smileage	OO Ganbaranakutemo Ee nende!![NLBP]
Xe1IOiDlwtc	Smileage	Tabidachi no harugakita[NLBP]
LN9mG9oqqfc	Smileage	Tachia Girl[NLBP]
CzNd9EnGiIM	Smileage	Yume Miru Fifteen[NLBP]
Oi_l9Cza-1A	TSUGUNAGA Momoko	Yurushite~nyan[NLTP]
SYLWe09cOjc	Tsukishima Kirari starring Kusumi Koharu	bararaika[NLBP]
fPAxWZ3Pzy4	v-u-den	Nanni mo Iwazu ni I LOVE YOU[NLBP]
LH7iuU5PqJM	TOPHAMHAT-KYO	Next Season[NLBP]
cZNfFWFLp8g	TOPHAMHAT-KYO	Sakuraful Palette[NLBP]
MRD7vADJs2A	TOPHAMHAT-KYO	Windy Indie[NLBP]
wG9hP14TMTM	Ange☆Reve	Ano natsu no Melody[NLBP]
EWW19FTapog	Ange☆Reve	Kiss me Happy[NLBP]
D3e-a_7vhTs	Ayumikurikamaki	Killla Tune[NLBP]
F-E1PwZrpFM	Ayumikurikamaki	Kizuna Mix[NLBP]
EOac641C6_M	Ayumikurikamaki	Tabidachino Uta[NLBP]
6xBOOR-stdQ	Ayumikurikamaki	War Cry[NLBP]
_v0wjd45DQI	BiSH	GiANT KiLLERS[NLBP]
JPxNUx8ie8w	BiSH	HiDE the BLUE[NLTP]
i90zUjc_J30	BiSH	Hontō honki[NLBP]
8y-dHKkp2zU	BiSH	Hoshi ga matataku yoru ni[NLBP]
OAJn4XRhr10	BiSH	Kienaide[NLBP]
96qqHCd3Ek0	BiSH	Kirin lemon[NLBP]
4j2NvbuUbs8	BiSH	MONSTERS[NLBP]
--ombqA70cI	BiSH	My landscape[NLBP]
fZ_wJe50YzQ	BiSH	NON TiE-UP[NLBP]
qjbua8Z47Hc	BiSH	Nothing[NLBP]
_RRbVhobb9o	BiSH	Orchestra[NLBP]
BpLLKM_3ebk	BiSH	OTNK[NLBP]
OaXiTwgkDAw	BiSH	PAiNT it BLACK[NLBP]
ox8WVRnb8GA	BiSH	Promise the Star[NLBP]
Rgjf4DzvFD0	BiSH	SMACK baby SMACK[NLBP]
mDYoE4pvM1E	BiSH	stereo future[NLBP]
EKQ6bIb0cSw	BiSH	Youji to tsuki no hime[NLBP]
RXm9m57X4o0	Cheeky Parade	CPU !? (PANORAMA Ver.)[NLBP]
X8VsEg1btbc	Chu-Z	a.no.ne[NLBP]
5FJWJvZEmFM	Chu-Z	Arch of flower[NLBP]
kQML2TENBSk	Chu-Z	Brand Boy[NLBP]
syMRM4VivTw	Chu-Z	GIRLS ON THE RUN[NLBP]
1nktTv73P_k	Chu-Z	Gonna be alright![NLBP]
Qd7EeCt7gmg	Chu-Z	Keep Me Out Of Heaven[NLBP]
96A8-2LKf-Y	Chu-Z	Let's Get The Party Started[NLBP]
fzyN8sogyOI	Chu-Z	Pariro~tsu![NLBP]
d9FTiDGwjow	Chu-Z	Tell me why umarete kita imi o shiritai[NLBP]
6o483Ib7cYo	Chu-Z	Torisetsu Nishino Kana (Idol version cover)[NLBP]
YPN-T31OfYw	CY8ER	Kakushi ~e ｰ mu[NLBP]
PGPH9SbFY4g	CY8ER	Kata omoi wazurai[NLBP]
XAjuJylAi-o	CY8ER	Sayonara Flash Back[NLBP]
XC3N46u8Eeo	CY8ER	Summer[NLBP]
4grZteJFFQI	CY8ER	Te to te[NLBP]
uio1h-YwikI	CY8ER	Time trip[NLBP]
fXF_E2rnffk	Especia	Abanchūru wa gin'iro ni[NLBP]
e089x6ba1Zo	Especia	No1 Sweeper[NLBP]
MwrD67oiR_8	Especia	Parliament[NLBP]
y6fsbFpD_fg	Especia	Twinkle Emotion[NLBP]
HKME266JpXY	FES☆TIVE	Disco rettō ukiyo no yume[NLTP]
5_rhTYh7BHg	FES☆TIVE	Dondoko matsuri zumu - moeagare taiko-chan[NLBP]
w-EDPoZpsX8	FES☆TIVE	Go Zipang[NLBP]
C3kZMko1EaM	FES☆TIVE	Magical Parade[NLBP]
MfRql4Dguls	FES☆TIVE	OIDEMASE!! ～Gokuraku～[NLTP]
FTwBkWm4Tyc	FES☆TIVE	Oma tsuri hero[NLBP]
FBWibezPQHA	FES☆TIVE	Yamatonadeshiko Sunrise[NLBP]
v6h-z-R0Wtw	FES☆TIVE	Yurayura yurari koigokoro[NLTP]
lqLgmc3vfRQ	Fragrant Drive	Mune no oku no Vermillion[NLBP]
A4Is97d3PPA	Fûdanjuku	Kimi iroiro utsuri[NLBP]
aCbP4RajcGQ	HimeKyunFruitCan	Koi no binetsu[NLBP]
ik5TW0oG-KQ	HimeKyunFruitCan	STAND UP!![NLBP]
Br0vFs0Ym6k	HimeKyunFruitCan	Tsubomi no sakura[NLBP]
aNlkiymcT1Q	Hinoi Team	Ike Ike[NLBP 250]
aTBlKRzNf74	Hinoi Team	Night of fire[NLBP]
F7tWSyZToZ4	Hinoi Team	NOW AND FOREVER[NLBP]
lu6_G1-EIjI	Hinoi Team	PLAY WITH THE NUMBERS[NLBP]
HtC6WWWBtbE	Hinoi Team	Sing Na Na Na[NLBP]
9i3VCVHzTAY	Hinoi Team	YEAH![NLBP]
29MFQnoC0HY	i☆Ris	Changing point[NLBP]
rd1GL0a8lt4	Last Idol	Sukide sukide shōganai[NLBP]
W1UbMZtAQG8	LinQ	Anata ni[NLBP]
Swtp-tRNCMM	LinQ	Calories nante[NLBP]
8FblXSZzK2A	LinQ	CHIKU TAKU[NLBP]
hXSttB4R3t4	LinQ	Colorful days[NLBP]
T2H5dJEoE9Y	LinQ	GARNET[NLBP]
c34H3NcqFWY	LinQ	Halle Halle ☆ Parade[NLBP]
LY9ep-J220k	LinQ	HANABI!![NLBP]
Z4X7yuUuakI	LinQ	Karorī nante[NLBP]
3d7UHgkVBlg	LinQ	LinQ 4th Anniversary ～ Welcome to the LinQworld !! ～[NLBP]
D4DS2klfPZw	LinQ	LinQuest -Yagate densetsue[NLBP]
6wVkJ1pMhcU	LinQ	Natsukoi[NLBP]
UCauUkVVLAI	LinQ	Sakura kajitsu[NLBP]
Z_1Gl4XhJgY	LinQ	Shiawase no enajī[NLBP]
v-aNll0kZKk	LinQ	Shitsuren photograph[NLBP]
8DEQXx3aUXA	LinQ	Supreme[NLBP]
j8I9Tf3BEKw	LinQ	Susume! Shōnen shōjo[NLTP]
b7t409oFer4	LinQ	UESSAI!! GASSAI!![NLBP]
AhNKy39dyFU	LinQ	You May Dream[NLBP]
6EaScnkskK8	Lovely★Doll	Bargain girl[NLBP]
e8buxs-yrRo	Lovely★Doll	Sōtaiseiriron[NLBP]
qVn3_qeIrBA	MOMOIRO CLOVER	PINKY JOHNS[NLBP]
oIMNVlde4nw	Momoiro Clover Z	HAKKIN NO YOAKE[NLBP]
ESGu10M49Zo	Momoiro Clover Z	Kurōbā to diamond[NLBP]
5degcfbioz4	Momoiro Clover Z	PUSH[NLBP]
oCRlKdMnPLI	Momoiro Clover Z	Z densetsu ~Owari naki kakumei~[NLTP]
tSBPUP3MQ2I	MOMOLAND	BBoom BBoom (Japanese version)[NLBP]
uOtJRjRFF6o	Niji No Conquistador	~This SummerGirl Is an Innocent Mistress~[NLBP]
_uYTSn6Pyak	Niji No Conquistador	Ai o kokoro ni samā to kazoeyo (niji kon)[NLBP]
BN8XtaPmLoE	Niji No Conquistador	Futari no shupūru[NLBP]
fH_rzbE1QdM	Niji No Conquistador	Jump![NLBP]
-8GyB1Y2PYE	Niji No Conquistador	kagirinaku bōken ni chikai samā[NLBP]
u1W6R8rjkv4	Niji No Conquistador	Natsu no yo wa mijikasugiru kedo…[NLBP]
mzEZFGOiR58	Niji No Conquistador	Triangle ・ Dreamer[NLTP]
7udQDzPMpoY	Niji No Conquistador	Zutto Summer de Koishiteru[NLBP]
bFY6szwQGwA	palet	All for One[NLBP]
d6IbH4a2h1g	palet	Mune no botan[SCALE 1.33][NLBP]
SaO_E9N6Bnc	palet	Over The Rainbow[NLBP]
jSNUSfQ0OrM	palet	SNOW DISTANCE[NLBP]
ewujzpVbUq8	palet	Time to Change[NLBP]
yTKfjYVI8no	PASSPO☆	7's Up[NLTP]
uwCpVXtRRY4	PASSPO☆	Bachelorette wa owaranai[NLBP]
Ptj5YsXK2J4	PASSPO☆	Candy Rooms[NLBP]
g-iAluMVmcs	PASSPO☆	Give me, give me action[NLTP]
KTkgRaSRUQQ	PASSPO☆	GPP[SCALE 1.2][NLBP]
BP1JYdzkiqQ	PASSPO☆	Growing Up[NLBP]
NypL3WmV-D4	PASSPO☆	Kimi wa boku o sukininaru[NLBP]
Gr_DzyDLopQ	PASSPO☆	Kiss=Suki[NLBP]
FABrxN3PEJo	PASSPO☆	Let It Go!![NLBP]
ONSvqJEHn-E	PASSPO☆	Mousou No Hawaii[NLBP]
rrSbn0_zt88	PASSPO☆	Mr.Wednesday[NLBP]
N3qTVP89mYE	PASSPO☆	Natsuzora Hanabi[NLBP]
D6HO30x54bk	PASSPO☆	Next Flight[NLBP]
2b-m539VJPU	PASSPO☆	Perfect Sky[NLBP]
yKWgWoIVehs	PASSPO☆	PlayGround[NLBP]
M_lTETi_xZQ	PASSPO☆	Sakurakomachi[NLBP]
B0XXb58WA6Y	PASSPO☆	Shōjo Hikō[NLBP]
A4ZyjqcpCdc	PASSPO☆	STEP＆GO[NLBP]
QJagZpocFCQ	PASSPO☆	Sutenda~tsupu gāruzu!~ Dai 1-wa damedame kaijū ni goyōshin ~[NLTP]
ob3gC7ifsWM	PASSPO☆	Truly[NLBP]
LyzWrixAEmE	PASSPO☆	ViVi Natsu[NLBP]
ICMUw7DPKjY	PASSPO☆	WING[NLBP]
G8iWvob0GjY	Pink Babies	Pepper Keibu in Paris[NLBP]
2m33WsTeMtQ	Pink Babies	UFO[NLBP]
CGWtP_9rH3c	Pink Babies	Wanted (Shimei Tehai)[NLBP]
mFZsCKBm3v4	Sleepiece	Medaka no Kyoudai[NLTP 125]
FxT0IFU5pAo	SUPER☆GiRLS	Akai jōnetsu[NLBP]
REEuxZqurhc	SUPER☆GiRLS	Bubble in the Squash![NLBP]
RIOZ0iQYfDs	SUPER☆GiRLS	Celebration[NLBP]
zUbxNV6wtKE	SUPER☆GiRLS	Ganbatte seishun[SCALE 1.33][NLBP]
dS8WQ3VfsNM	SUPER☆GiRLS	Giragira Revolution (Short ver.)[NLBP]
tFvNT0o4xGo	SUPER☆GiRLS	Hanamichi! ! A ~ nbishasu (Short Ver.)[NLBP]
9jQViQIR7LY	SUPER☆GiRLS	Itchya ♪ Yatsucha ♪ (Short ver.)[NLBP]
7Zmw-wP67ds	SUPER☆GiRLS	Kareinaru V!CTORY (Short ver.)[NLBP]
b1tQbWXZw2s	SUPER☆GiRLS	Kongura CHU bājon!!!![NLBP]
u0RdJDvNxVk	SUPER☆GiRLS	ＭＡＸ！Otomekokoro[NLBP]
rWRGRqlciCY	SUPER☆GiRLS	Mi-ra kuruga yama n na i~tsu![SCALE 1.33][NLBP]
GUKahpj243g	SUPER☆GiRLS	PAKA-PAN![NLBP]
hbJDw0ew9Xc	SUPER☆GiRLS	Puripuri ♥SUMMER KISS[NLBP]
r3p-1BKybaA	SUPER☆GiRLS	Sorairo no kiseki (Short Ver.)[NLBP]
qUfD97rasz0	SUPER☆GiRLS	Suite ☆ Smile (Short ver.)[NLBP]
9SGDieDamek	SUPER☆GiRLS	Tokonatsu high touch (Short ver.)[NLBP]
dn3uOTdHJ5I	Team Syachihoko	JUMP MAN[NLBP]
nHnjTT6escM	TEMPURA KIDZ	LOLLIPOP[NLBP]
Wlck1K0VWSo	TEMPURA KIDZ	TEMPURA KIDZ in Shibuya PARCO[NLBP]
X3H-4crGD6k	TWICE	I WANT YOU BACK[NLBP]
DdLYSziSXII	TWICE	Wake Me Up[NLBP]
uTtlmB_hV1M	Wa→suta	Galbi (Girls, Be) Ambitious![NLBP]
fLrERBaV3Pk	Wa→suta	The Biggest Paradox[NLTP]
_ioaEaqnNPU	Yumemiru Adolescence	Fantastic Parade[NLBP]
zxu8WlFUjFk	Yumemiru Adolescence	Idol Race[NLTP]
4JveP5YJLtE	Yumemiru Adolescence	Melon Soda[NLBP]
RwDUH8ZgSF0	Yumemiru Adolescence	Summer Nude Adolescence[NLBP]
K0eHyU68eKU	Zenbu Kimi no Sei da.	Female genome phenomenon[NLBP]
uKvsQ10In6Y	Zenbu Kimi no Sei da.	Kawa Mei zen'ya[NLBP]
Xiydr2Ihc44	Zenbu Kimi no Sei da.	Misfit Lovers[NLBP]
3fTugx8OoMk	Zenbu Kimi no Sei da.	Misfit Lovers[NLBP]
qtN-mDFSt1Y	Zenbu Kimi no Sei da.	Natural Born Independent[NLBP]
RIDt6wOIZw0	Zenbu Kimi no Sei da.	Romance sect[NLBP]
hWX4NnVeEgY	Zenbu Kimi no Sei da.	Wagamama Shinsei Hominina[NLBP]
94lJ8aFKV2g	Fumidō	I Love You[NLBP 250]
FsIQRNurMtk	Fumidō	Merry Christmas [NLC][NLBP 250]
p2hZzyB_KvQ	Fumidō	Nakimushi no Uta[NLBP]
1LSyUap15lE	Fumidō	Takaramono[NLBP]
jOWC2wzYkJw	H ZETTRIO	Journey[NLBP]
mlURSNEiAFg	YOSHIKI	MIRACLE (Sarah's Version)[NLBP]
QyDPRmBoWos	Aldious	Lose Control[NLBP]
RJcbEnxqV1k	Aldious	Re:fire[NLBP]
hraBdfH2xfI	Aldious	SWEET TEMPTATION[NLBP]
sfkJT0rra-8	Aldious	We Are[NLBP]
UnrGCp-N7Bo	ANTHELION	THE TOME OF BROKEN SOULS[SCALE 1.33][NLBP]
AttcCxA7gZ8	ANTHEM	Black Empire[NLBP]
1ce456Nnkt8	BABYMETAL	Distortion[NLBP]
cirhQ8iLdbw	BABYMETAL	Doki Doki☆Morning[NLBP]
WIKqgE4BwAY	BABYMETAL	Gimme chocolate!![NLBP]
0GErGfHjHQ0	BABYMETAL	Headbangeeeeerrrrr!!!!![NLBP]
qVdBBOpSoN4	BABYMETAL	Iine![NLBP]
nDqaTXqCN-Q	BABYMETAL	Ijime,Dame,Zettai[NLBP]
GvD3CHA48pA	BABYMETAL	KARATE[NLBP]
cK3NMZAUKGw	BABYMETAL	MEGITSUNE[NLBP]
pDgqo6fcliY	BABYMETAL	NO RAIN, NO RAINBOW[NLTP]
zTEYUFgLveY	BABYMETAL	Road of Resistance[NLBP]
hPVx7IazcEw	BABYMETAL	Starlight[NLBP]
TZRvO0S-TLU	BABYMETAL	THE ONE[NLBP]
tuWSDgk3cEY	BABYMETAL feat. Rob Halford	Breaking The Law[SCALE 1.33][NLTP]
1Lxfd229f3Y	BABYMETAL feat. X JAPAN	Benitsuki -Akatsuki-[NLBP]
wKZbzcUdY1g	BAND MAID	YOLO[NLBP]
Zuj_-z5-06w	BAND-MAID	Before Yesterday[NLBP]
T_PWQtc7zVw	BAND-MAID	Bubble[NLBP]
MZIJ2vFxu9Y	BAND-MAID	Choose me[NLBP]
RCaeUkrItyY	BAND-MAID	Daydreaming[NLBP]
xmxEuQXTHUU	BAND-MAID	DOMINATION[NLBP]
0YGwUhg2XNk	BAND-MAID	Don’t let me down[NLBP]
TAMiLTiXPpU	BAND-MAID	Glory[NLBP]
9TkHpvaO09c	BAND-MAID	REAL EXISTENCE[NLBP]
1Vuca7V-5Ec	BAND-MAID	secret My lips[NLBP]
iL5sRrSECQ0	BAND-MAID	start over[NLBP]
ItYN-ri1NPs	BAND-MAID	the non-fiction days[NLBP]
Uds7g3M-4lQ	BAND-MAID	Thrill[NLBP]
umSt7oMUMcs	BAND-MAIKO	Gion-cho[NLBP]
NNHGABwme50	BAND-MAIKO	secret MAIKO lips[NLBP]
kqDrry5K1nk	BRATS	AINIKOIYO (TO BE HERO Opening Theme)[NLBP]
ntJditD8hpQ	BRATS	Doudatte yokatta[NLBP]
tSXfJHUEKjI	BRATS	Kimarigoto (LIVE Ver. - NEXT LIVE Oct.7 2018)[NLBP]
73HxSYyXhnQ	BRATS	Kimarigoto[NLBP]
ZJoORsoPOto	BRATS	NONAI SHOKYO GAME (Slavemen Theme Song)[NLBP]
GLqr1Y5QJuE	BRATS	Unfair[NLBP]
g8urHOmxvS8	BRIDEAR	Dear Bride[NLBP]
LQIDqudG_DQ	BRIDEAR	IGNITE[NLBP]
UxSrOqAxaKw	BRIDEAR	Light In The Dark[NLBP]
hr4b10Rhf4E	Broken By The Scream	Harūrara[NLBP]
4Eum9rFdFQc	Broken By The Scream	Koi wa otome no nakidokoro -[NLBP]
_GRPfla05iI	Broken By The Scream	oh！my！ME・GA・MI ni koishiteru！[NLBP]
Q8qOH-f6doM	Broken By The Scream	Sayonara bāsudē -[NLBP]
feJ6ePgiVNM	CROSS VEIN	EXISTENCE[NLBP]
zpJYvCCfSEU	CROSS VEIN	Graceful Gate[NLBP]
YIlgHvxDxTk	Crossfaith	Astral Heaven[NLBP]
KlvK9bgubQ4	Crossfaith	Calm The Storm[NLBP]
OOG_qW7XNB4	Crossfaith	Catastrophe[NLBP]
4H0Wn5XXtXM	Crossfaith	Eclipse[NLBP]
BT4env-Tw2o	Crossfaith	Jägerbomb[NLBP]
UDbtnDBWk_o	Crossfaith	Madness[NLBP]
7nVND9k6p-s	Crossfaith	Make A Move[NLBP]
cGJfO3P4s04	Crossfaith	Omen[NLBP]
figqjvbKhRU	Crossfaith	Raise Your Voice[NLBP]
1yy4JW1PA18	Crossfaith	Rx Overdrive[NLBP]
O9rQvJhmpVo	Crossfaith	System X VIP Xeno[NLBP]
2hMusqyfhjc	Crossfaith	Tears Fall[NLBP]
Nk5dfdieOCs	Crossfaith	The Evolution[NLBP]
ZF7oY3scww4	Crossfaith	The Perfect Nightmare[NLBP]
bswkClwZxeA	Crossfaith	Wildfire[NLBP]
R4c2tGS83e4	Crossfaith	Wipeout[NLBP]
-d_RuZhuR-k	Crossfaith feat. Ho99o9	Destroy[NLBP]
VYWbnIPbnJo	Crossfaith feat. Rou Reynolds	Freedom[NLBP]
CKHsfceVK2g	Crystal Lake	AEON[NLBP]
jX8RTjUUcLE	Crystal Lake	Apollo[NLBP]
9n3mMdYvEV4	Crystal Lake	Chosen Ones[NLBP]
yjr9TZjTqIM	Crystal Lake	Devilcry[NLBP]
FAH9I-Qvb3g	Crystal Lake	Feels[NLBP]
VYPJPgo24-s	Crystal Lake	Hail To The Fire[NLBP]
6BFgs2PloFI	Crystal Lake	Lost In Forever[NLBP]
6OnOXCu-BCI	Crystal Lake	Matrix[NLBP]
DngsyBIuqCQ	Crystal Lake	Mercury[NLBP]
CvJQ1pFBi8A	Crystal Lake	Omega[NLBP]
iwpSkz7DdrU	Crystal Lake	Prometheus[NLBP]
6WyZ2GcdmCM	Crystal Lake	Rollin'[NLBP]
DuB2kyN8wzI	Crystal Lake	THE CIRCLE[NLBP]
7jv_TXeMXI4	Crystal Lake	True North[NLBP]
8119XHDKTLk	Crystal Lake	Ups&Downs[NLBP]
Z4z756LQVOc	Crystal Lake feat. JESSE (RIZEThe BONEZ)	Black And Blue[NLBP]
Fw74pypwbC0	Crystal Lake feat. Kenta Koie from Crossfaith	Belove[NLBP]
nIPeXFfGBXA	DOLL＄BOXX	HERO[NLBP]
ClqWiPRU2Co	DOLL＄BOXX	KARAKURI TOWN[NLBP]
R2itu5KEvG0	DOLL＄BOXX	Loud Twin Stars[NLBP]
BZhuzMmO03o	DOLL＄BOXX	monopoly[NLBP]
ZWJk5oEULf8	DOLL＄BOXX	Omochanoheitai[NLBP]
FVfRwBeCnE0	DOLL＄BOXX	Shout Down[NLBP]
iqGK5Gls72o	DOLL＄BOXX	Sub - liminal[NLBP]
mu2z4Uf9Tgc	DOLL＄BOXX	Take My Chance[NLBP]
Xd-luMQNkVw	Erabareshi	Motto, nee motto[NLBP]
Hdj7ik5ssxQ	Exist † Trace	RESONANCE[SCALE 1.33][NLBP]
KdYms5pRwS4	Fear, and Loathing in Las Vegas	Chase the Light![NLBP]
Hi76rUxG6SQ	Fear, and Loathing in Las Vegas	Keep the Heat and Fire Yourself Up[NLBP]
D-SQqppuGvc	Fear, and Loathing in Las Vegas	Let Me Hear[NLBP]
aJ-zaQRrkf8	Fear, and Loathing in Las Vegas	LLLD[NLBP]
NsOQm7A7hMo	Fear, and Loathing in Las Vegas	Love at First Sight[NLBP]
BDFD2WopIjY	Fear, and Loathing in Las Vegas	Rave up Tonight[NLBP]
o3nbOl2-g-s	Fear, and Loathing in Las Vegas	Return to Zero[NLBP]
2k55xXm0ido	Fear, and Loathing in Las Vegas	Scream Hard as You Can[NLBP]
EcSQQqk95gA	Fear, and Loathing in Las Vegas	SHINE[NLBP]
m4tgYsjVsDw	Fear, and Loathing in Las Vegas	The Sun Also Rises[NLBP]
CGsOgZCmwPs	Fear, and Loathing in Las Vegas	Treasure in Your Hands[NLBP]
Ng4hyD8AWJk	FRUITPOCHETTE	Bōgyaku PARASITE[NLBP]
3zWwd8n2JVI	LADYBABY	Age Money[NLBP]
C6pf2lSoJJs	LADYBABY	bite me[NLBP]
yhT2-oX5kzk	LADYBABY	C'est si bon Kibun[NLBP]
cBk6cH96Tbo	LADYBABY	Damedame-dono[NLTP]
iqBFMF15qZU	LADYBABY	Haten ni Raimei[NLTP]
M8-vje-bq9c	LADYBABY	Nippon manju[NLBP]
oA6UYTbOEMQ	LADYBABY	Renge Chance ![NLTP]
mMWwyRSsL5E	LADYBABY	Riot Anthem[NLBP]
7_F1x0cKoVE	LADYBABY	Starless Sky[NLTP]
OiF-GILQsU0	LADYBABY feat. Ladybeard	Biri Biri Money[NLTP]
Zx9KPfvMVjY	LOVEBITES	Don't Bite The Dust[NLBP]
ueKyQ4xI-mY	LOVEBITES	Jimonjitō TOUR MATSURI SESSION[NLBP]
B70JsOpmUGE	LOVEBITES	Rising[NLBP]
imYCuDXWd9I	LOVEBITES	Shadowmaker[NLBP]
k3wyUbfl6TY	LOVEBITES	Shadowmaker[NLBP]
SkdgTnbm2Tw	LOVEBITES	The Crusade[NLBP]
MLM2unV0kwU	Mary's Blood	Marionette[NLBP]
2YV6IJLoBv4	MAXIMUM THE HORMONE	Chīsana kimi no te[NLBP]
dn17-EfMNY8	MAXIMUM THE HORMONE	Haikei VAP dono [SKIP AT 4:20][NLTP]
IC-wDpwzEt4	MAXIMUM THE HORMONE	Korekara no men katakoteri no hanashi o shiyou[NLTP]
beN5ep5MrdY	MAXIMUM THE HORMONE	Revenge[NLTP]
TdwT5JlH8gM	MAXIMUM THE HORMONE	Tsume Tsume Tsume[NLTP]
AOWJ2Vdk3jo	MAXIMUM THE HORMONE	What's up people?[SCALE 1.33][NLBP]
htnOxvseJbE	NECRONOMIDOL	ABHOTH[NLBP]
y88BXeo1ogo	NECRONOMIDOL	Atai no Tsume Ato[NLBP]
h0m5BgAgixA	NECRONOMIDOL	BLOOD RED SKIES Opening Animation[NLBP]
ZlpQZ2Ln-Xs	NECRONOMIDOL	ITHAQUA[NLBP]
vVacOaFbrdE	NECRONOMIDOL	SKULLS IN THE STARS[NLBP]
3DcF0FjtdCs	ONMYO-ZA	Konpeki no sōba[NLBP]
dk3G7WQKqJ0	PassCode	Asterisk[NLBP]
WjZTw8LQf3o	PassCode	AXIS (live at Studio Coast, 2016)[NLBP]
WQgC7MLB9ng	PassCode	AXIS[NLBP]
3GSsYJM1oM0	PassCode	Cry Out (live at Studio Coast, 2016)[NLBP]
EROmeuwmIls	PassCode	Gekidō Puroguresshibu[NLBP]
hkQwyU-cUOA	PassCode	It's you (Lyric Video)[NLBP]
RtYWltM9gu8	PassCode	MISS UNLIMITED (live at Studio Coast, 2016)[NLBP]
X48UZ4j9N04	PassCode	MISS UNLIMITED[NLBP]
Z6sCxX7FkT8	PassCode	Nextage (live at Studio Coast, 2016)[NLBP]
GObrpzFp2lA	PassCode	ONE STEP BEYOND (live at TSUTAYA O-EAST, ZENITH TOUR 2017)[NLBP]
ReiVKYreaj4	PassCode	PROJECTION[NLBP]
bI0_Hx__dFU	PassCode	Ray[NLBP]
lCRpxvO-BBQ	PassCode	Same to you[NLBP]
EzPDdM5Riks	PassCode	Taking you out (Taking you out TONIGHT! Tour 2018)[NLBP]
Wmt86RKEkuY	PassCode	Taking you out[NLBP]
YzNXj9a6blE	PassCode	Tonight[NLBP]
si8wX1j5ots	PassCode	TRACE (live at Studio Coast, 2016)[NLBP]
7w6SNisu5ug	PassCode	TRACE[NLBP]
jQFfJEQpu8o	Sadie	Bleach[NLBP]
lRV2aoQ--94	Seikima-II	EL DORADO[SCALE 1.33][NLBP]
AUl9j-Jws60	SHIORI Tomita feat. Ladybeard	Valentine Kiss (Music Japan show, Jan 18 2016)[NLTP]
2oxsrLs1o6Y	TEARS OF TRAGEDY	Astrea[NLBP]
0K3huB5XmAA	TEARS OF TRAGEDY	It Like Snow... (Acoustic Version)[NLBP]
f2OtgpKYSP8	TEARS OF TRAGEDY	Spring Memory[NLBP]
HFJNo5AZEtY	TEARS OF TRAGEDY	VOICE (Acoustic Version)[NLBP]
N6P52F6tPYM	TEARS OF TRAGEDY	Void Act[NLBP]
O5GwtmMFibY	The Idol Formerly Known As LADYBABY	Easter Bunny[NLBP]
TwcK4ZHrG_o	The Idol Formerly Known As LADYBABY	LADY BABY BLUE[NLBP]
GQCY_Iof-Tg	The Idol Formerly Known As LADYBABY	Me! Me! Me![NLBP]
6Rsktmz1DZI	The Idol Formerly Known As LADYBABY	Pelo[NLTP]
gT6rxu38NSI	The Idol Formerly Known As LADYBABY	Pinky! Pinky![NLTP]
vkxC5CVEtlk	The Idol Formerly Known As LADYBABY	Sanpai! Goshuinｇｉｒｌ☆[NLBP]
V8i_QhOgsKw	Unlucky Morpheus	Black Pentagram[NLBP]
TiQdl2toBtg	Unlucky Morpheus	Knight of Sword[NLBP]
x1I3JLVs8YI	Versailles	Aristocrat's Symphony[NLBP]
U87yQg29-gA	Versailles	Truth[NLBP]
PtX73nBZnYI	X JAPAN	Born to be free[NLTP]
GSoLM3_ZepQ	X JAPAN	DAHLIA[NLBP]
ejPTlnY930I	X JAPAN	Drain[NLBP 250]
LeyoxuhX-dQ	X JAPAN	IV[NLBP]
W_3iWAN43qY	X JAPAN	Jade[NLBP]
GROH1-Uq5ec	X JAPAN	Rose of Pain (Live With Orchestra)[NLBP]
M1dcM1pGZS8	X JAPAN	Rusty Nail (Anime Version 1994)[NLBP 250]
arPxBqDmjAc	X JAPAN	X (We are)[NLBP]
djoSwti3mXw	moumoon	15 Doors[NLBP]
QX5ovzdUSWE	moumoon	All You Wanted (Michelle Branch cover) (FULLMOON LIVE 2017 JUNE-)[NLBP]
jmVTP3yNICU	moumoon	Bon Appetit[NLBP]
7J-n6fl6TOA	moumoon	Chu Chu[NLBP]
_MraBTGvnAs	moumoon	Cinderella (FULLMOON LIVE 2017 SEPTEMBER)[NLBP]
JyGiDghtwz8	moumoon	cocoon[NLBP]
YygTgPPQMLA	moumoon	Do you remember?[NLBP 250]
qdJaZPD8pJQ	moumoon	DREAMER DREAMER[NLBP]
3nNUbfTI4mo	moumoon	Emerarudo no oka[NLBP]
YIQr41gUof8	moumoon	EVERGREEN[SCALE 1.33][NLBP]
UMV2QKLoQ5k	moumoon	Flowers[NLBP 250]
BuUFEC4ekvM	moumoon	Good Night (acoustic version)[NLBP]
ADO81iy2VIo	moumoon	Hakana hi[NLBP]
50HiguJmarY	moumoon	Hakana hi[NLBP]
ODnJTCDg9LU	moumoon	Hallelujah[NLBP]
tUuymfbnDRY	moumoon	Happy New Year Acoustics![NLBP]
zTm666EKYRs	moumoon	Hello, shooting star[NLBP]
KsxcXe6D8ow	moumoon	I say You say I ♥ you[NLBP]
dqripSQzQ0U	moumoon	I'm Scarlet[NLBP]
2y60UXZXitk	moumoon	IROIRO[NLBP]
_mc9EhvCSjo	moumoon	It’s Our Time[NLTP]
ff0eozrx9Dk	moumoon	Jewel[NLBP]
SBDXBIUyrTQ	moumoon	Let's dance in the moonlight[NLBP]
11xgsCYuNp0	moumoon	LOVE before we DIE[NLBP]
yz4pk7Q3KgE	moumoon	Love is Everywhere[NLBP]
YeUbvC8zPuQ	moumoon	Love is Everywhere（FROM LIVE TOUR 2014～LOVE before we DIE～ IN SHIBUYA)[NLBP]
b7ny6068GCI	moumoon	moonlight[NLBP]
3JLBKp_CpEs	moumoon	more than love[NLBP 250]
2ZnVnx-C6fY	moumoon	Moshibi[NLBP]
B6rt2asC160	moumoon	moumoon's footsteps (Medley)[NLBP]
ASbGKPxX2_E	moumoon	myself[NLBP 250]
MbAs9zmk5ys	moumoon	On the right[NLBP]
XT3yyxlPmxQ	moumoon	September (Earth Wind & Fire cover)[NLBP]
Y16x_uNGjpo	moumoon	Sunshine Girl[NLBP]
-VRVwZWBJKY	moumoon	Swallowtail Butterfly[NLBP]
L0UC5JXfTno	moumoon	SWEET HEART[NLBP]
7KB1yiKFFMs	moumoon	Time after Time (Cindy Lauper cover)[NLBP]
JC-CU-d44Z0	moumoon	Tiny Star[NLBP 250]
n7XK2n6RbsE	moumoon	Tomodachi koibito[NLBP]
Er2ppZ07808	moumoon	Uta o utaou[NLBP]
uL66fronQro	moumoon	Uta o utaou[NLBP]
dyuMVckPsQU	moumoon	Wild Child[NLBP]
fjoNnG-U6JU	moumoon	YAY[NLBP]
Vhd9MZFQy_c	MAN WITH A MISSION	2045[NLTP]
8MqoTIteXDs	MAN WITH A MISSION	DANCE EVERYBODY[SCALE 1.33][NLBP]
JjIiK9VcIsA	MAN WITH A MISSION	Dead End in Tokyo[NLBP]
v59KwX32rg8	MAN WITH A MISSION	distance[SCALE 1.33][NLBP]
2mPhZpnk7aY	MAN WITH A MISSION	Dive[NLBP]
2wEs4jsv9gc	MAN WITH A MISSION	Dog Days[NLBP]
6Q7Gcw-fqJg	MAN WITH A MISSION	DON'T LOSE YOURSELF[NLBP]
HIRfc3ybbPg	MAN WITH A MISSION	Emotions[SCALE 1.33][NLBP]
oVvEjZckgpI	MAN WITH A MISSION	evils fall[NLBP]
XWHrmqk88IQ	MAN WITH A MISSION	Far[NLBP]
XD_ySnd3SpA	MAN WITH A MISSION	Feel and Think[SCALE 1.33][NLBP]
rYS9ZdGt9Ko	MAN WITH A MISSION	Find You[NLBP]
1QEKNvw4DPU	MAN WITH A MISSION	FLY AGAIN[SCALE 1.33][NLBP]
mjef-vaqRTs	MAN WITH A MISSION	FROM YOUTH TO DEATH[SCALE 1.4][NLBP]
0lh1jDNxi0o	MAN WITH A MISSION	Get Off of My Way feat. GEROCK[NLBP]
4VfxhCUUhbA	MAN WITH A MISSION	HASTA LA VISTA[NLBP]
ejhRu-l4Zm8	MAN WITH A MISSION	Hey Now[NLBP]
JDdIJcWtlFA	MAN WITH A MISSION	higher[NLBP]
RqTZO07EuDQ	MAN WITH A MISSION	Left Alive[NLBP]
yM6-QVxIXTs	MAN WITH A MISSION	My Hero[NLBP]
7Z36hHTwi4M	MAN WITH A MISSION	NEVER FXXKIN' MIND THE RULES[NLBP]
G-UN6uRMBRw	MAN WITH A MISSION	Raise Your Flag[NLBP]
2Vzksex5REE	MAN WITH A MISSION	Seven Deadly Sins[NLBP]
A3GDqIdLTKc	MAN WITH A MISSION	Smells Like Teen Spirit[NLBP]
C9c8QymgYXY	MAN WITH A MISSION	TAKE ME HOME[NLBP]
4hSEZdezI44	MAN WITH A MISSION	Take Me Under[NLBP]
aIW6UafTwGE	MAN WITH A MISSION	Take What U Want[SCALE 1.33][NLBP]
1FprZqWK_Fo	MAN WITH A MISSION	The Anthem[NLBP]
_YWV9-G0700	MAN WITH A MISSION	whatever you had said was everything[NLBP]
najilYBAn_k	MAN WITH A MISSION	When My Devil Rises[NLBP]
b-Ma_fd1aXg	MAN WITH A MISSION	Winding Road[NLBP]
XzWcameJDow	MAN WITH A MISSION feat. TAKUMA	database (10-FEET)[NLBP]
TMSN3a2x98w	MAN WITH A MISSION feat. Tokyo Ska Paradise Orchestra	Freak It![NLBP]
AM6v-N2ZRrk	MAN WITH A MISSION×Zebrahead	Out of Control[NLBP]
ihNaFCEd0Ms	Perfume	1mm[NLBP]
gYaxQYf_EdI	Perfume	Baby cruising Love[NLBP]
seESL1hsPas	Perfume	Baby cruising Love Macaroni[NLBP]
aC-SUaZ_Jag	Perfume	ceramic girl[NLBP]
1WTy2yqKI4w	Perfume	Chocolate Disco[NLBP]
guqVgQFvXXY	Perfume	Cling Cling[NLBP]
jOXGKTrsRNg	Perfume	Computer City[NLBP]
rBX5YGPNDbs	Perfume	Dream Fighter[NLBP]
H7zhpMbRoUs	Perfume	Edge[NLBP]
8zh0ouiYIZc	Perfume	Electro World[NLBP]
VZKMaFR2mtU	Perfume	FAKE IT[NLBP]
q6T0wOMsNrI	Perfume	FLASH[NLBP]
kfqToOh7MVA	Perfume	Fushizen na Girl[NLBP]
cGlFxkWgI84	Perfume	Future Pop[NLBP]
EWYgmgqQVS4	Perfume	Future Pop[NLBP]
H3RBn3MG8ms	Perfume	GLITTER[NLBP]
tomx9IzAS5A	Perfume	Hold Your Hand[NLBP]
CZa4fyhQXBc	Perfume	I still love U[NLBP]
pFc9PZrroOk	Perfume	If you wanna[NLBP]
vjBRxHq_mxM	Perfume	Kasuka Na Kaori[NLBP]
K54CYowOqxM	Perfume	Laser Beam Kasuka na Kaori[NLBP]
hXxDNaSzRwg	Perfume	Let Me Know[NLBP]
jyTiZUbL_Qg	Perfume	Linearmotor Girl[NLBP]
75hg0XFVByw	Perfume	love the world[NLBP]
NhI2mp-WIck	Perfume	Magic of Love[NLBP]
s8_vqfjYpBg	Perfume	Mirai no Museum[NLBP]
ZRm5woxMmfM	Perfume	Monochrome Effect[NLBP]
Q51bru32S7A	Perfume	Mugen Mirai[NLBP]
VvuQ138Xxcs	Perfume	My Color[SCALE 1.33][NLBP]
edyARJq9sgM	Perfume	Nachuraru ni koishite[NLBP]
PXAlCazm3J0	Perfume	Natural ni Koishite[NLBP]
nbeGeXgjh9Q	Perfume	Nee[NLBP]
cMsGcW-xaYU	Perfume	One Room Disco[NLBP]
DbSdjR4TwnM	Perfume	Perfect Star Perfect Style[NLBP]
fTJbL9OGF00	Perfume	Perfect Star Perfect Style[SCALE 1.33][NLBP]
XFspdThBHqM	Perfume	Perfect Star, Perfect Style (LIVE BlurayDVD)[NLBP]
vhfYis6VuXY	Perfume	Pick Me Up[NLBP]
KbiSxunJatM	Perfume	Polyrhythm[NLBP]
ySlbW5o0bHg	Perfume	Relax In The City[NLBP]
th8H34qOk30	Perfume	Secret Secret[NLBP]
H4znsXCH_2Y	Perfume	Spending all my time[NLBP]
biMO46z_VSY	Perfume	Spice[NLBP]
HBGOKTZDFv8	Perfume	Spring of Life (ABU TV Song Festival 2012)[NLBP]
7PtvnaEo9-0	Perfume	Spring of Life[NLBP]
pR2E2OatMTQ	Perfume	STAR TRAIN[NLBP]
WgahV6_GPyM	Perfume	Sweet Doughnut[NLBP]
CYL3DnyA4e0	Perfume	Sweet Refrain[NLBP]
vxl4gsvgEQY	Perfume	TOKYO GIRL[NLBP]
Dk3jWsARsX4	Perfume	Twinkle Snow Powdery Snow[NLBP]
aLo2_lLFPqQ	Perfume	Vitamin Drop[NLBP]
9_ifx-Dmv9g	Perfume	VOICE[NLBP]
3FoA6cypkYg	AAA	777 ～We can sing a song!～[NLBP]
ZIQSgmFz1YI	AAA	Kuchibiru kara romanchika[NLBP]
b0xwKL4lpfk	AAA	mint[NLBP]
-0T0Ijgin3o	AAA	MUSIC!!![NLBP]
ZTO8Fl-fDf8	AAA	Tabidachinōta[NLBP]
3WHoSlrxzCY	AAA	Wonderful Life[NLBP 250]
XTDRCwqqtC0	Apink	Bye Bye[NLBP]
Gon3zZ421Bk	COLOR CREATION	Butterfly[NLBP]
VeklQeM5Te4	COLOR CREATION	CANVAS[NLBP]
_dBOfGadkFs	COLOR CREATION	Waiting For You[NLBP]
Ao5Xl8J94Ok	CTS	Sayonara Twilight[NLBP]
VJS8D68tejk	Czecho No Republic	Baby Baby Baby Baby[NLBP]
gM9pqmGrqnA	Czecho No Republic	Curiosity[NLBP]
0bNNBA4Pg8s	Czecho No Republic	Dinosaur[NLBP]
7sy1_Cv5cpk	Czecho No Republic	Dream Beach Sunset[NLBP]
4PY2mjD40A0	Czecho No Republic	Electric Girl[NLBP]
ub41YYtrSkc	Czecho No Republic	Everything[NLBP]
cfRYJfFvsWI	Czecho No Republic	Festival[NLBP]
ZREIq7SpI_I	Czecho No Republic	Firework[NLTP]
oPNXRlzNZWc	Czecho No Republic	Ivory[NLBP]
U2ylTdlKr74	Czecho No Republic	Massachusetts[NLBP]
1AMOiDgVMS4	Czecho No Republic	MUSIC[NLBP]
JpUZN_Sjqrw	Czecho No Republic	Neverland[NLBP]
NyHUflC-EP0	Czecho No Republic	No Way[NLBP]
zqC3tkbhfRA	Czecho No Republic	Oh Yeah!!!!!!![NLBP]
KYOkHq8prOA	Czecho No Republic	One waltz[NLBP]
RWUx6v5rb_o	Devil ANTHEM.	EMOTIONAL[NLBP]
ZE5s93T3XKI	Devil ANTHEM.	Etto nere mishi[NLBP]
2J-LKwGSOyM	Devil ANTHEM.	Fake Factor[NLBP]
3UTE-3V9XoQ	Devil ANTHEM.	Fever[NLBP]
S65wnDvPYjU	Devil ANTHEM.	Kakusei WOW WOW[NLBP]
c6c9jpWjHXs	Devil ANTHEM.	Kimi no hāto o seifuku-chū[NLBP]
QvpGkaRQHNY	Devil ANTHEM.	Like a nettaiya[NLBP]
P_kKBOjffMM	Devil ANTHEM.	Race to go!![NLBP]
w4XAz8Nlk4c	dream	Get Over[NLBP]
Pq_mbTSR-a0	Dreamcatcher	PIRI[NLBP]
5gtUZ_nFopA	Dreamcatcher	We All Lie[NLBP]
1BxgWbqxMzk	Ebi Shide	Sanagika no on'na (mushi no on'na) togawa jun[NLBP]
lVo3cFkdkXY	Every Little Thing	Feel My Heart[NLBP 250]
gMHP8ZXvuMM	GFRIEND	FLOWER[NLBP]
JPZKpiBC_5o	GIRL NEXT DOOR	～Destiny's star～[NLBP]
4Kg62_HEI6g	GIRL NEXT DOOR	Gūzen no Kakuritsu[NLBP]
HFf5Qwtt93U	GIRL NEXT DOOR	Seeds of dream[SCALE 1.33][NLBP]
p5kc8hJ3GcA	Goose House	Hikaru Nara[NLBP 125]
iI74IGxvugQ	Goose house	M (PRINCESS PRINCESS Cover)[NLBP]
YKwXix967PI	Goose house	Sparkle (Your Name OST RADWIMPS Cover)[NLBP]
YPntLtgN_F0	Haokun Gu	Nishino kana airabuyū[NLTP]
qtCm5pQcYsA	Howadoru	Love is Shubidubiduba![NLTP]
dlLq9LXCQRY	I Don't Like Mondays.	FIRE[NLBP]
z67IoU5p1LU	I Don't Like Mondays.	LEMONADE[NLBP]
wpM6C2Ac0j4	I Don't Like Mondays.	Perfect Night[NLBP]
qv3Uc4vh2ew	I Don't Like Mondays.	TONIGHT[NLBP]
3WlOZTy072k	iri	Wonderland[NLBP]
vsO2WxwOeyc	Kabushikigaisha Yamitsuki Company	Sickness[NLBP]
-su426eFStM	Kalafina	Believe[NLBP]
H83NdYaewTE	Kalafina	Blaze[NLBP]
i190q5WzRHo	Kalafina	Fairytale[NLBP 250]
K28TcPN-BsQ	Kalafina	Far on the Water[NLBP]
ZwfjS5CvedM	Kalafina	Heavenly Blue[NLBP]
-wILF0YwvNM	Kalafina	Hikari No Senritsu[NLBP]
fjj5WbtenTM	Kalafina	Hikariful[NLBP]
_U1dosZ5A4M	Kalafina	Hyakka Ryouran[NLBP]
3HiUdr7VtJs	Kalafina	Into the World[NLBP]
N7GU7-fvWQA	Kalafina	Kagayaku Sora no Shijima ni wa[NLBP]
XkSjf0ah-O4	Kalafina	Kiminoginnnoniwa[NLBP]
6kgJBzCXr4Y	Kalafina	Lacrimosa[NLBP]
QwquipMpsiQ	Kalafina	Magia[NLBP]
mxABgqQdX7g	Kalafina	One Light[NLBP]
i2A1sgMShn8	Kalafina	Progressive[NLBP]
v6vwADf_qzQ	Kalafina	Ring Your Bell[NLBP]
okkzd3FLYJo	Kalafina	Seventh Heaven[NLBP]
edSaT8e65oQ	Kalafina	Sprinter[NLBP 250]
zOYpZrz_eYk	Kalafina	Storia[NLBP]
OWmNcmXZwfs	Kalafina	Symphonia[NLBP]
b1bXu0XZDlU	Kalafina	to the beginning[NLBP]
ItjnF7Q9IrU	Ketsumeishi	Ballad[NLBP]
CZcMY1UqLkI	Little Glee Monster	Gyutto[NLBP]
WH1cmXidUzQ	Little Glee Monster	Hikaru Kakera[NLBP]
vmo2PEUazhQ	Little Glee Monster	Hokago High Five[NLBP]
F0XtNUomydE	Little Glee Monster	Itsuka Kono Namidaga[NLBP]
kKsow3IB_F4	Little Glee Monster	Jinsei Wa Ichidokiri[NLBP]
-e4STsHcTZ4	Little Glee Monster	Over[NLBP]
eaJHiX8z8Og	Little Glee Monster	Sekai Ha Anatani Waraikaketeiru[NLBP]
qJT9gnmCWeY	Little Glee Monster	Sukida[NLBP]
74-BTyXnVJc	Little Glee Monster	Watashi Rashiku Ikitemitai[NLBP]
xQjfv_SHBQI	Little Glee Monster	Youth photograph[NLBP]
8NcIOBreZpc	LoVendoЯ	Coward[NLTP]
mi4DjLyzqDk	LoVendoЯ	Fake[NLTP]
txnRWv3iQaQ	LoVendoЯ	I'm clumsy[NLTP]
yes3hI0IR3c	LoVendoЯ	It's fine, isn't it?[NLTP]
2DqNK1JKTT8	LoVendoЯ	Moment[NLTP]
lv80mrLuiZM	LoVendoЯ	Ordinary me, Let's give it a try![NLTP]
AiO5ZPxq0EE	LoVendoЯ	Shoot! Baby, I love ya![NLTP]
nF9waJh72c8	LoVendoЯ	The Boy[NLTP]
boFKrQptghA	LoVendoЯ	Treasure[NLTP]
ThmN41XqsIA	LoVendoЯ	Weeping silently[NLTP]
67K6oXHyf_Q	m.o.v.e	around the world[SCALE 1.33][NLBP]
7OkzGLgyyCw	m.o.v.e	BREAK IN2 THE NITE[NLBP]
xiBNUL4bm-0	m.o.v.e	come together[SCALE 1.33][NLBP]
naC-6RyD-eI	m.o.v.e	DISCO TIME[SCALE 1.33][NLBP]
GKURxNMi2xA	m.o.v.e	DOGFIGHT[SCALE 1.33][NLBP]
jmN95py8wB4	m.o.v.e	FREAKY PLANET[SCALE 1.33][NLBP]
EOyXVAa-KjI	m.o.v.e	How To See You Again[NLBP]
832PY73ZLgM	m.o.v.e	i WAKE YOUR LOVE![SCALE 1.33][NLBP]
X6a26MOL6Iw	m.o.v.e	Painless PAIN[SCALE 1.33][NLBP]
KoFSQeOAYz4	m.o.v.e	Rage your dream[NLBP 250]
mfqrU5ILj20	m.o.v.e	Raimei ~out of kontrol~[SCALE 1.33][NLBP]
rkdudijS5Ik	m.o.v.e	Romancing Train[SCALE 1.33][NLBP]
KLvOlTzZyLE	m.o.v.e feat. 8-BALL	SPEED MASTER[SCALE 1.33][NLBP]
Pl78_ggfV-0	Mahousyoujoninaritai	Ki Ra Ri[NLBP]
gO9a4KOXwXU	Manu	Tenki Ame[NLBP]
KalpF-sXR3c	Murmur	Wanka [SKIP AT 4:33][NLBP 250]
1fO0mY5vLA8	Official HIGE DANdism	Brothers[NLBP]
Vho5jBUfR28	Official HIGE DANdism	Coffee and syrup[NLBP]
sem3UU-EQJs	Official HIGE DANdism	FIRE GROUND[NLBP]
n0e0y01w92A	Official HIGE DANdism	Koi no maenarae[NLBP]
TQ8WlA2GXbk	Official HIGE DANdism	Pretender[NLBP]
22mOCjkwQjM	Official HIGE DANdism	Stand By You[NLBP]
qrtKLNTB71c	Official HIGE DANdism	SWEET TWEET[NLBP]
3IDvi4buNdk	Official HIGE DANdism	Tell Me Baby[NLBP]
PB8dUVLPnuo	Official HIGE DANdism	What's Going On?[NLTP]
b54YUfZoPiU	Passepied	Hyper Realist[NLBP]
v4P1JsHOe88	Passepied	MATATABISTEP[NLBP]
ftV3TOYIFNI	Passepied	Nagasugita Haru[NLBP]
iWFIk9Os_ww	Passepied	Nanairo No Shonen[NLBP]
PEBy3aegIvE	Passepied	Neon & Tiger[NLBP]
fiYpjEPpvDc	Passepied	Nōnai sensō[NLBP]
Jw4B9_40iv8	Passepied	ONE[NLBP]
FgIEGHTGTlg	Passepied	Plastic girl[NLBP]
3svykRR83w4	Passepied	S.S[NLBP]
OpkUVVUYZm8	Passepied	SUPERCAR[NLBP]
--pQC5XH2-E	Passepied	To oryan se[NLBP]
JodIjt0Oq-o	Passepied	TOKINOWA[NLBP]
4Gm7qYBkfr8	Passepied	Tsukuri Hayashi[NLBP]
R6aj-hpk6AY	Passepied	Ura no Ura[NLBP]
kIqn6QGnxdU	Passepied	Yoakemae[NLBP]
U-nSZkBSvXI	Passepied	Zeitakuna Iiwake[NLBP]
-YJxGg3ZZYw	Porno Graffitti	Animarossa[NLBP]
E9KnAqb3yVE	Porno Graffitti	Apollo[NLBP]
AhOhkl_89vk	Porno Graffitti	Haneuma Rider[NLBP]
ouYttvc0fwg	Porno Graffitti	Hitorino Yoru[NLBP]
AfUegR-ebVE	Porno Graffitti	Koyoi, Tsukiga Miezutomo[NLBP]
nX0pB9oqvsk	Porno Graffitti	Matataku Hoshino Shitade[NLBP]
hvn7qmNoj48	Porno Graffitti	Melissa[NLBP 250]
qOje5ZlKKoI	Porno Graffitti	Music Hour[NLBP]
j686pXItayc	Porno Graffitti	Oh! Rival[NLBP]
enucVO_6nMs	Porno Graffitti	Saudade[NLBP]
2SVZ_2z79rQ	Porno Graffitti	The Day[NLBP]
U0OCIr90XA4	PRINCESS PRINCESS	M[NLBP]
OotYO-O-mMI	QUEEN BEE	Venus[NLBP]
LIlZCmETvsY	Sakanaction	Shin Takarajima[NLBP]
Hf4U1QlixeE	Shiggy Jr.	Beautiful Life[NLBP]
Rtft9TT67k8	Shiggy Jr.	GHOST PARTY[NLBP]
65eYy_CgQSw	Shiggy Jr.	Koi Shitara Baby[NLBP]
tL9fUvUQbFM	Shiggy Jr.	LISTEN TO THE MUSIC[NLBP]
gq5DPSPP47g	Shiggy Jr.	Saturday night to Sunday morning[NLBP]
aexE38LoNEo	Shiggy Jr.	Thank you[NLBP]
I7BbcxKrI48	Stereopony	Chiisa na Mahou[NLBP]
vYV-XJdzupY	Stereopony	Hitohira No Hanabira[SCALE 1.33][NLBP]
RCe-BQmjLbk	Stereopony	Namida No Mukou[SCALE 1.33][NLBP]
B9gMJsvgzg4	Stereopony	Stand By Me[SCALE 1.33][NLBP]
YpyfCaBgqJI	T.M.Revolution	Invoke[NLBP]
Qs9C5sVJuVs	Taiiku Okazaki	Natural Lips[NLTP]
bLz_voPFQ1I	Tainaka Sachi	Itoshii Hito e - Live 2007 Concert[SCALE 1.33][NLBP]
G0sqczw8h0U	Tancobuchin	DO RE MI FUN LIFE[NLBP]
rqJj94ASUtE	THE APRILS	ASTRO[NLBP]
qd1Zl3mzsRM	THE APRILS	Kaede Newtown[NLBP]
1xaSKNqOZJo	THE APRILS	Pan-da[NLBP]
e4DQDR0yXi4	the Raid.	Kagiana[NLBP]
7dlK7mmcCbE	TM NETWORK	BEYOND THE TIME[NLTP]
LgBxze0ye94	TM NETWORK	Get Wild[NLTP]
QMq05b2nfmM	Tsuji Shion	Yukou[NLBP]
Y-T1et5vYyo	Up Up Girls	Agenomics! ![NLBP]
ms-JJEvtxwg	Up Up Girls	Ai ai Fire!![NLBP]
8hSLRIxvTm0	Up Up Girls	Joujou Dokonjou[NLTP]
xata9rAEOAs	Up Up Girls	Jumper![NLBP]
SpBw25pUc1M	Up Up Girls	Kimi to iu kasetsu[NLTP]
OTV7AS8qsoY	Up Up Girls	Love Love fire!![NLBP]
gHxmXufqwRg	Up Up Girls	parade[NLBP]
iQ6qM5OAr70	Up Up Girls	Party People Alien[NLBP]
YLZI3hdrnYU	Up Up Girls	Run Run Run[NLBP]
wYYeFHbp2WQ	Up Up Girls	Seven☆Peace[NLTP]
7_fuCxzXwR4	Up Up Girls	Upperlay[NLBP]
sT_Ygn8Wnss	Up Up Girls	Watashitachi[NLTP]
GTFN3B13uoM	Up Up Girls	We are Winner![NLBP]
76tCy8sJNq8	Up Up Girls (2)	Angel Enjite 20nen[NLBP]
K_xTet06SUo	Wagakki Band	Senbon sakura[NLBP]
GxPzyo_ZF1o	Who the Bitch	Akai Lemon Tea[NLBP]
hqLOvm8T9wk	YANAKIKU	FUJIYAMA△DISCO JPN ver.[NLBP]
SX_ViT4Ra7k	YONEZU Kenshi 	Lemon[NLBP]
9aJVr5tTTWk	YONEZU Kenshi 	Peace Sign[NLBP]
yTzc2VnjkQw	Goose house	Kore Ga Watashi No Ikiru Michi (Puffy AmiYumi cover)[NLBP 250]
9PQPg8aF2jk	Puffy AmiYumi	~Urei~[NLBP]
RlptXrUlwe8	Puffy AmiYumi	Ai no shirushi[NLBP]
7QEcjHeSH4Q	Puffy AmiYumi	All Because of You[NLBP]
LeqYawBra3E	Puffy AmiYumi	Aoi namida[NLBP]
lFfNKXeYrFk	Puffy AmiYumi	Asia No Junshin (Live)[NLBP]
ebbcPIsv-Ds	Puffy AmiYumi	Asia No Junshin[NLBP]
ASo1tQUWgO4	Puffy AmiYumi	Atarashii Hibi[NLBP]
OyNDReKYnl4	Puffy AmiYumi	Boogie Woogie No. 5[NLBP]
P0i-xJojqIA	Puffy AmiYumi	Boom Boom Beat (Live)[NLBP]
63V_67e-8po	Puffy AmiYumi	Boom Boom Beat[NLBP]
AlCGetHGtJ4	Puffy AmiYumi	Bouken no dadada[NLBP]
XsNfwxxfbw8	Puffy AmiYumi	Bye Bye[NLBP]
8C_dAkydGZE	Puffy AmiYumi	Circuit no Musume (Live)[NLBP]
nCCUJBmkg1M	Puffy AmiYumi	Circuit No Musume[NLBP 275]
f0Dgg5LWInc	Puffy AmiYumi	Closet Full of Love[SCALE 1.33][NLBP]
bzt_lHrjNkM	Puffy AmiYumi	COLORFUL WAVE SURFERS[NLBP]
pu1VSJ-QnCw	Puffy AmiYumi	Darekaga[NLBP 250]
ehlYiSPbEdk	Puffy AmiYumi	Datsu Dystopia[NLBP]
WkKL2aMmVzU	Puffy AmiYumi	Forever[NLBP]
VhiQC-mi4Io	Puffy AmiYumi	Friends Forever (Live)[NLBP]
FFt5eyknWyg	Puffy AmiYumi	Friends forever[NLBP]
uaeJVr475Mc	Puffy AmiYumi	Hajimari No Uta[NLBP]
4SxcGF-gnqU	Puffy AmiYumi	Happy Birthday[NLBP]
7VBTLPv74i0	Puffy AmiYumi	Hatarakuyo[NLBP]
A3lDjUA_Sw4	Puffy AmiYumi	Hi!Hi! Puffy AmiYumi Show Theme[NLBP]
wKMfAhsebZI	Puffy AmiYumi	Hiyori hime[NLBP]
2LSwaMqQP04	Puffy AmiYumi	Hurricane[NLBP]
RM_utiVYojI	Puffy AmiYumi	Joining a Fanclub[NLBP]
hoWynebkAtM	Puffy AmiYumi	K2g[NLBP]
w0OlECserNA	Puffy AmiYumi	Kimi Ni Go (Live)[NLBP]
c4bGMUe85RM	Puffy AmiYumi	Korega watashi no ikiru michi[NLBP]
19bKreZqNJk	Puffy AmiYumi	Kuchibiru Motion[NLBP]
JKxlK1fIrv0	Puffy AmiYumi	LOVE SO PURE (Live)[NLBP]
YrFrPQiJHv8	Puffy AmiYumi	Moguralike[NLBP]
CaVxe4nVamc	Puffy AmiYumi	Mother[NLBP]
9dJnfkd26_M	Puffy AmiYumi	My Story[NLBP 250]
tht0SnekaLM	Puffy AmiYumi	Nagisani Matsuwaru etc.[NLBP 275]
PUqZ92iSVYE	Puffy AmiYumi	Nehorina Hahorina[NLBP]
CObJx8ReZOU	Puffy AmiYumi	Nice Buddy[NLBP]
QLJhYacatjw	Puffy AmiYumi	Nichiyōbi no musume[NLBP]
l6rOSdT4H0U	Puffy AmiYumi	Nichiyōbi no musume[NLBP]
AdupoOGgAkY	Puffy AmiYumi	Oh! Edo Rocket[NLBP]
B9NhG-_CXFM	Puffy AmiYumi	Oriental Diamond[NLBP]
UtxalYljEAw	Puffy AmiYumi	PAFFIPIPOYAMA[NLBP]
ggmWJoPiUdM	Puffy AmiYumi	R.G.W.[NLBP]
y5X2m-tSjZE	Puffy AmiYumi	Red Swing[NLBP]
S8KAFm2uHdI	Puffy AmiYumi	Sayonara[NLBP]
6o6qfpzw928	Puffy AmiYumi	Security Blanket[NLBP]
vlvOG3Q1Tas	Puffy AmiYumi	Shiawase[NLBP]
z5U0gdyKxKw	Puffy AmiYumi	Sunrise[NLBP]
fQ0ODgSJ-C0	Puffy AmiYumi	Susume Nonsense[NLBP]
C5ugqcj1Q_g	Puffy AmiYumi	Sweet Drops[NLBP]
RuSkmX9Pto4	Puffy AmiYumi	Tararan[NLBP]
xhhOMceBJv8	Puffy AmiYumi	Teen Titans[NLBP]
4knKrMsWk_U	Puffy AmiYumi	Toku Suru Karada[NLBP]
iSL6g_v1ntI	Puffy AmiYumi	Tokusuru Karada[NLBP]
oMs1TPiB7r8	Puffy AmiYumi	Tokyo I'm On My Way (Live)[NLBP]
rPQD02kDy_Q	Puffy AmiYumi	Tokyo I'm on My Way[NLBP]
1gDBEKZUBUo	Puffy AmiYumi	Tomodachino Wao![NLBP]
hclseIQ9hKs	Puffy AmiYumi	Toyo Soseki[NLBP]
MZz4r6CRFEg	Puffy AmiYumi	Umi Eto[NLBP]
5xa_30nVr_w	Puffy AmiYumi	Vacation[NLBP]
vrGy1aGXYFc	Puffy AmiYumi	Wedding Bell[SCALE 1.33][NLTP]
pIL5Hk8uKQ4	Puffy AmiYumi	Yuki Ga Furu Machi[NLBP]
GBZ9HM4Zy1w	Puffy AmiYumi	Yume no Tame ni[NLBP]
M4I_TETFAGY	Puffy AmiYumi feat. Tokyo Ska Paradise Orchestra	Hazumu Rhythm[NLBP 250]
2FhguXZSbMA	TheRulingThumb	Mother (Puffy AmiYumi cover)[NLBP]
weTOksrjR0E	Kyūso Nekokami	Giri Shōwa[NLTP]
ql0YKIzl6Q0	MUCC	Arcadia[SCALE 1.33][NLBP]
ZqSRKha48Qk	MUCC	Classic[NLBP]
qNam4x2eGeY	MUCC	ENDER ENDER[NLBP]
IjfR9It_xVQ	MUCC	Falling Down[NLBP]
48JJ77DuurM	MUCC	G.G.[SCALE 1.33][NLBP]
tKG3qC12LQ0	MUCC	MOTHER[SCALE 1.33][NLBP]
2tkuZtej4jI	MUCC	Nirvana[NLBP]
10SFeESBQ4c	MUCC	World's End[NLBP]
mHidPbYuQJs	MUCC	Yueni Matenrou[NLBP]
Rji72MJ5G6U	Stance Punks	I Wanna Be[SCALE 1.33][NLBP]
azKXMj24v08	THE CHERRY COKE$	~ Sarabaseishun'nohikari ~[NLBP]
x3GRsLM82V8	THE CHERRY COKE$	Bullet For Vapid Beer[SCALE 1.33][NLBP]
4dyPZuLdWf4	THE CHERRY COKE$	Dong Chang Swag[NLBP]
fxJf5utlgMw	THE CHERRY COKE$	DRUNKEN PIRATES ~ Owari naki yorunohate ~[NLBP]
E_XOaHfGhgc	THE CHERRY COKE$	KISS IN THE GREEN ～Drunken lovers nite～[NLBP]
VqjtuAEJseU	THE CHERRY COKE$	MAGICAL FANTASY[NLTP]
YXFSr_JFVj0	THE CHERRY COKE$	RISE AGAIN[NLTP]
Oi_-ZDqVYN0	THE CHERRY COKE$	Sakura fune～Sail Of Life～[NLBP]
x-A5RtjtQAk	THE CHERRY COKE$	SNOWS IN THE TOWN[NLTP]
o2aZg5Y3Yzc	THE CHERRY COKE$	Speak Easy[NLBP]
_pS2GHdJdC8	WANIMA	Nagisa no utakata[NLBP]
XRnX65LDRoU	RADWIMPS	25 Ko-me no senshokutai[SCALE 1.33][NLBP]
-0DZQaxPH5s	RADWIMPS	311 Mikkusu sashikae[NLTP]
dyr58XHuRYU	RADWIMPS	Ai towa[SCALE 1.33][NLBP]
sY9ollwdXdo	RADWIMPS	Buriki[NLBP]
czWpz8gH7eY	RADWIMPS	Catharsist[NLBP]
Yy6XeGCNkSM	RADWIMPS	DADA[NLBP]
gmLXEmCExIE	RADWIMPS	Futarigoto[NLBP 250]
IPN9mzWT21E	RADWIMPS	Geitaidenwa[SCALE 1.33][NLBP]
WuU6C8oXzIA	RADWIMPS	Guāng[NLBP]
CW8NjjLQCcE	RADWIMPS	Haru-tō[NLTP]
iHUnUHA5hek	RADWIMPS	Kaiko[NLBP]
44oq8Me0h8I	RADWIMPS	Mímí[NLBP]
CetVGsV6g44	RADWIMPS	Ōdāmēdo[SCALE 1.33][NLBP]
7MaF-bWeLGw	RADWIMPS	Osha kasha ma[SCALE 1.33][NLBP]
5jKwQDiwPLY	RADWIMPS	Saihate Aini[NLBP]
R1vmfVpINbk	RADWIMPS	Sokkenai[NLBP]
Z2rSGq7KxLo	RADWIMPS	Tayuta[SCALE 1.33][NLBP]
TgxOMybZ_o0	RADWIMPS	Ｔｕｍｍｙ[NLBP]
WXTENfNj29M	RADWIMPS	Yoru no fuchi[NLBP]
a2GujJZfXpg	RADWIMPS	Your name[NLBP]
c2y8Ba3WwPY	RADWIMPS	Yushinron[SCALE 1.33][NLBP]
PDSkFeMVNFs	RADWIMPS	Zen zen zense[NLBP]
eKXz9H6-Hao	RADWIMPS feat. AIMYON	Naki dashi-sōta ゙yo[SCALE 1.33][NLBP]
oi8ArKYLwBY	AliA	Kakurenbo[NLBP]
DkEMVK2fAp8	AliA	limit[NLBP]
VHlfTVTAhnQ	BABYRAIDS JAPAN	Pretty Little Baby[NLBP]
HLGpU9MO3ZA	FERN PLANET	Forest Nest[NLBP]
R8NdDzebdBg	FERN PLANET	Satellite Search Light[NLBP]
EnZuLUHEpFs	FERN PLANET	Soldier Girls[NLBP]
xLopLGFqglI	GIRLFRIEND	15[NLBP]
8n5uOE1Bdog	GIRLFRIEND	Fashion Monster (Kyary Pamyu Pamyu cover)[NLBP]
VEBiszeabkg	GIRLFRIEND	FLASH (Perfume cover)[NLBP]
NfrlCdkPxtE	GIRLFRIEND	GO FOR IT!! (Nishino Kana's cover)[NLBP]
-YeDUGBSxwQ	GIRLFRIEND	Happiness[NLBP]
-dGOvoIS25I	GIRLFRIEND	Heroine ni naritai (short ver.)[NLBP]
YGO5tm6Sbl4	GIRLFRIEND	Hide & Seek[NLBP]
Nt-IzikpX9c	GIRLFRIEND	If it is a full moon night (AYMION cover)[NLBP]
qt6YR_Zk0Fo	GIRLFRIEND	Influencer (Nogizaka 46 cover)[NLBP]
kDszzzwZiLI	GIRLFRIEND	Itchokusen[NLTP]
4jXPzIINGpI	GIRLFRIEND	KisekiRush[NLBP]
D3NTm6BqDIk	GIRLFRIEND	Lemon (Gen Yonezu cover)[NLBP]
GZUqcIg9t5I	GIRLFRIEND	LIFE (AAA cover)[NLBP]
6F2R9kwaBvs	GIRLFRIEND	LOVE SURVIVE (SCANDAL cover)[NLBP]
zaNfYiSUnn8	GIRLFRIEND	Mirai List[NLBP]
sQHDvvDitH8	GIRLFRIEND	Miryoku to wa?[NLBP]
_hcbNt48XZs	GIRLFRIEND	Sukida (Little Glee Monster's cover)[NLBP]
aTqEzQdetqk	hAngry & Angry	Ｔｏｐ Ｓｅｃｒｅｔ[NLBP]
FM48Mu0dVX8	Hangry & Angry	Top Secret[NLBP]
y_OdzwDq3Ig	hAngry & Angry-f	Reconquista[NLBP]
kBSui-ux7ZI	HANGRY&ANGRY	Kill Me Kiss Me[NLBP]
iAvJLT9gsAs	HANGRY&ANGRY	Reconquista (JAPAN EXPO 2011)[NLBP]
R1Zo7TBseYg	KOISURUENBAN	ELMER[NLBP]
A3lhPlwKAa8	ONEPIXCEL	Girls Don't Cry[NLBP]
zzh-bM8gGiY	ONEPIXCEL	LAGRIMA[NLBP]
ALYd3cxyT68	ONEPIXCEL	sora[NLBP]
6UoldZ9hN6k	ONEPIXCEL	Sparkle[NLBP]
Az7rUUlcgKs	ONEPIXCEL	Time[NLBP]
YAm3NgaTOq8	ONEPIXCEL	TONDEKE[NLBP]
48OAPYnpiL8	SCANDAL	Awanai Tsumori no, Genki de ne[NLBP]
4JjAjLDESI4	SCANDAL	Departure[NLBP 125]
EvpLcjF5tvI	SCANDAL	Doll[NLBP]
v9CzXAa7LUY	SCANDAL	FREEDOM FIGHTERS[NLBP]
vTUTFw8e0U4	SCANDAL	Harukaze[NLBP]
KHhqg4R0qiQ	SCANDAL	Harukaze[NLTP]
fCGjaaAYJT8	SCANDAL	Mabataki[NLBP]
t-qVp94jB1o	SCANDAL	Masterpiece[NLBP]
oDOFAvg6L2A	SCANDAL	Pinheel Surfer[NLBP]
tQirIJxwFMk	SCANDAL	Platform syndrome[NLBP]
u0iaShRMilA	SCANDAL	PlayBoy[NLBP]
g1Qbs4VbQRQ	SCANDAL	Pride (Live)[NLBP 125]
i7ybwjJw_Vc	SCANDAL	Pride[NLBP 125]
M-e7Z9IQLy4	SCANDAL	sakura goodbye[NLBP]
3HAyGw9XF9I	SCANDAL	Scandal in the House[NLTP]
it-Vh9RYYCI	SCANDAL	Secret Base Kimi ga Kureta Mono[NLTP]
WYl6WRELkYw	SCANDAL	Shojo S[NLBP]
HEkerSi5Fig	SCANDAL	Shunkan Sentimental[NLBP]
ujGzGH3r8cM	SCANDAL	Sisters[NLBP]
zldBTSx9JpE	Sheena Ringo	Gips[NLBP]
qhPLK1Tn1GQ	SHISHIDO Kavka	Love Corrida[NLBP]
upHEGJGlc-I	SILENT SIREN	19 Summer Note.[NLBP]
mb6NHdXCp3o	SILENT SIREN	AKANE[NLBP]
AIjOh4Rc81E	SILENT SIREN	alarm[NLBP]
A4IOQg8C5hY	SILENT SIREN	BANG!BANG!BANG![NLBP]
Sl7B_7h2-OM	SILENT SIREN	Cheribom[NLBP]
NTvgA2odTrg	SILENT SIREN	Crazy Lady[NLBP]
WdmJ95qU_aM	SILENT SIREN	Firutā[NLBP]
4dOq4V4r8Uw	SILENT SIREN	FUJIYAMA DISCO[NLBP]
YiIfdOrQO6c	SILENT SIREN	Go Way![NLBP]
TuRm1JzAsVg	SILENT SIREN	Hachigatsu no yoru[NLBP]
QvpEQ2jrUP0	SILENT SIREN	Joshi-kō sensō[NLBP]
bbUehF1HULU	SILENT SIREN	Just Meet[NLBP]
crGzlCuaTGg	SILENT SIREN	KAKUMEI[NLBP]
EItnl7wcQZk	SILENT SIREN	Koino Esper[NLBP]
cID8aSNwLo0	SILENT SIREN	Liàn xuě[NLTP]
tXkMTa6748A	SILENT SIREN	ODOREmotion[NLBP]
MYbRVT4M4ho	SILENT SIREN	Routine[NLBP]
_Vc0Dgviono	SILENT SIREN	Sayonara hibiya[NLBP]
KCo86ecuofI	SILENT SIREN	Sweet Pop![NLBP]
798yCee_6mA	SILENT SIREN	Tenkaippinno Theme[NLBP]
A6bblKIvU_c	SILENT SIREN	Yoshida-san[NLBP]
IZYQtvwqUks	SILENT SIREN	Yumeoi[NLBP]
QgtNbfo-mSs	THE BAWDIES	KICKS![NLBP]
CCwCPvd0NTU	The Heana Cat	Base Hiitemita Desu ★[NLBP]
LNMNNQkbH5Y	The Heana Cat	Chi ~yokochokochokottochokocho dai[NLBP]
NVICy6AtGgc	The Heana Cat	Gokiburi[NLBP]
O-EyOzIU80s	The Heana Cat	Koi ga Shitai[NLBP]
f1oORze4qiI	The Heana Cat	Muchūdoku[NLBP]
FPKaRuZKMSw	The Heana Cat	Muchūdoku [NLN][NLBP]
qMHaxvQdHb8	The Heana Cat	Oborozuki[NLBP]
28tM5pfmXwA	The Heana Cat	Rururu[NLBP]
VrI3at_WqyU	THE MUSMUS	Aoba to warutsu[NLBP]
HZgWQLFIpjA	THE MUSMUS	Binary[NLBP]
nkf9yD3gcUs	THE MUSMUS	MARINE SNOW[NLBP]
fVpVz2UWdb8	THE MUSMUS	Müller[NLBP]
zeHjdd-sqSY	THE NOVEMBERS	BAD DREAM[NLBP]
Wxq_LpRQJlA	the peggies	Baby![NLBP]
bk5PlwUZ_7k	the peggies	Glider (Live)[NLBP]
LPFt3Fe3uPk	the peggies	Glider[NLBP]
iEEWXzBLmB8	the peggies	JAM[NLBP]
-GoZOCNSIYw	the Peggies	Kimi No Sei[NLTP]
z4R85yxk21c	the peggies	LOVE in the TOKYO[NLBP]
ayjQA9_5azY	the peggies	LOVE TRIP[NLBP]
CF2Ir2OFQgE	the peggies	Sputnik[NLTP]
ZNdPXPQsNI8	TRILL-DAN	Princess[NLBP]
9qLB_7pAnLQ	UNLIMITS	Last dance[NLBP]
HnxpNd0I93A	UPLIFT SPICE	23ya [NLN][SCALE 1.33]
ZEERXgPJcjU	UPLIFT SPICE	Hanabi no Iro[SCALE 1.33][NLBP]
QtJCn7FVidg	UPLIFT SPICE	Justice[NLBP]
av8jt4M3CuI	UPLIFT SPICE	Kanojo[NLBP]
I3fE_wvErXA	UPLIFT SPICE	Memento[NLBP]
XHcgR3lWZJk	UPLIFT SPICE	Minority parade[NLBP]
kfdbe0w2NPQ	UPLIFT SPICE	Minority Parade[NLBP]
fWaMQZJhIdE	UPLIFT SPICE	NGC224[SCALE 1.33][NLBP]
rvR2Dv1fT0c	UPLIFT SPICE	Omega Rythm[NLBP]
uY-QrSbVRW8	9mm Parabellum Bullet	Garasu no machi no Arisu[NLBP]
zIa5-CsMotA	9mm Parabellum Bullet	Hangyaku no māchi[NLBP]
pWH11t2JKds	9mm Parabellum Bullet	Hāto ni hi o tsukete[NLBP]
8DizBlRFMD4	9mm Parabellum Bullet	Inferno[NLBP]
Ad5B0wS5Huc	9mm Parabellum Bullet	Nameless Hero[NLBP]
m5A8Mz-D_74	ALEXANDROS	KABUTO[NLBP]
hWiki8UOImY	ALEXANDROS	Run Away[NLBP]
ZDpY1AgdYJE	AMEFURASHIQUALTET	bird[NLBP]
VI_rg-TnGNs	androp	Voice[NLBP]
bRWQckbQ9tQ	BUMP OF CHICKEN	Answer[NLBP]
6NQbSN85kJQ	BUMP OF CHICKEN	Aurora[NLBP]
Fk4sgvvHyeI	BUMP OF CHICKEN	Bōen no March[NLBP]
qVrM-BxWybA	BUMP OF CHICKEN	Butterfly[NLBP]
G6s8HF1WsJY	BUMP OF CHICKEN	Hanashi ga shitai yo[NLBP]
rOU4YiuaxAM	BUMP OF CHICKEN	Hello,world![NLBP]
2WY1wrwpd3k	BUMP OF CHICKEN	Kinen satsuei[NLBP]
V5ehe-cAbfg	BUMP OF CHICKEN	Nagareboshi no shōtai[NLBP]
_4BLiOP1aaY	BUMP OF CHICKEN	ray[NLBP]
6m3A1MP_gbU	BUMP OF CHICKEN	Ribon[NLBP]
uFDGkmwapy8	BUMP OF CHICKEN	Spica[NLBP]
E8AxtVpOjFA	either	Hometown[NLBP]
7WsT7ZWqv88	either	youthless[NLBP]
VtmE2YkTlDU	EXILE SHOKICHI	Underdog[NLBP]
WjRbZnpqjaU	FoZZtone	Master of Tie Breaker (Live)[NLBP]
45qPH71Bxew	Frederic	Endless May Day[NLBP]
c9nUD4iwrSA	Frederic	Hello Goodbye[NLBP]
qaOVcOq2McE	Frederic	Hyōhyō to Emotion[NLBP]
0H7VWEfekv8	Frederic	LIGHT[NLBP]
t_RogQwLq-M	Frederic	Night Step[NLBP]
PCp2iXA1uLE	Frederic	oddloop[NLBP]
oCrwzN6eb4Q	Frederic	Only Wonder[NLBP]
VjAxLbmy83E	Frederic	Rererepeat[NLBP]
YZdDKQHLu50	Frederic	Sukiraism[NLBP]
M1iXjgaYh1w	Frederic	Tōhikō[NLBP]
Ngl2EyR-dSY	go!go!vanillas	Magic [SKIP AT 2:45][NLBP]
WfMEHQjHdH4	HOTEI	Thrill[NLBP]
XxAVgMMRLPc	HYDE	AFTER LIGHT[NLBP]
tTJxOamTkQg	HYDE	MAD QUALIA (Japanese Version)[NLBP]
_wKq_C_LzM0	HYDE feat. YOSHIKI	ZIPANG (Japanese Version)[NLBP]
dQVl8urlE2o	MONOEYES	Free Throw[NLBP]
riyjAo3szbQ	MONOEYES	Get Up[NLBP]
tMVQ7trVuGM	MONOEYES	Get Up from Dim The Lights Tour 2017 at Studio Coast[NLBP]
pppstt1_YZw	MONOEYES	My Instant Song[NLBP]
h4zZh2TXHyo	MONOEYES	Run Run[NLBP]
iDTc2lP-Tbw	MONOEYES	Two Little Fishes[NLBP]
Tnz--TIKDu0	MONOEYES	When I Was A King (Cold Reaction Tour 2015 at Studio Coast)[NLBP]
UlmhKXA77ro	ONE OK ROCK	Answer Is Near[NLBP]
C-xF2MAFw5s	ONE OK ROCK	C.h.a.o.s.m.y.t.h[NLBP]
ha6Fy_LeWtI	ONE OK ROCK	Change (Japanese Version)[NLBP]
z2ed0Tazw0E	ONE OK ROCK	Change[NLBP]
6YZlFdTIdzM	ONE OK ROCK	Clock Strikes[NLBP]
tcBBNB5JTOQ	ONE OK ROCK	Deeper Deeper[NLBP]
xGbxsiBZGPI	ONE OK ROCK	Kanzen kankaku DREAMER[NLBP]
sF1larH1-bc	ONE OK ROCK	Keep IT Real[NLBP]
n8l73l6yZlo	ONE OK ROCK	Koi no aibô kokoro no cupid[NLBP]
SAHvDE9FFAE	ONE OK ROCK	Liar[NLBP]
gyshJYTEXgU	ONE OK ROCK	Mighty Long Fall[NLBP]
UjZqcDYbvAE	ONE OK ROCK	Mighty Long Fall[NLBP]
qKW4lqj2cNU	ONE OK ROCK	NO SCARED[NLBP]
67m9E6uDgxs	ONE OK ROCK	Re:make[NLBP]
WiQoO3NRVpg	ONE OK ROCK	Smells Like Teen Spirit[NLBP]
bFHcgBfZEq0	ONE OK ROCK	Stand Out Fit In (Orchestra Version)[NLBP]
IGInsosP0Ac	ONE OK ROCK	Stand Out Fit In[NLTP]
Hh9yZWeTmVM	ONE OK ROCK	The Beginning[NLBP]
b4YLo74OWfY	ONE OK ROCK	Wasted Nights[NLBP]
CRLLWNIqb8w	ONE OK ROCK	We are (Japanese Ver.)[NLBP]
uEcx-S69bWE	Polysics	Domo Arigato Mr Roboto[NLBP 250]
N0q0W9uJzIA	Polysics	Electric Surfin' Go Go[NLBP]
0Yi3dLek4SI	Polysics	Everybody Say No[NLBP]
DjARMDNBG1U	Polysics	How are you?[NLBP]
JLFrJtCg8bU	Polysics	I My Me Mine (All Star Version)[NLBP 250]
SqIPDAsmSjg	Polysics	Let's Daba Daba[NLBP]
_jrd9VX2CnM	Polysics	Lucky Star[NLBP]
hhS0KozuxEo	Polysics	MEGA OVER DRIVE[NLBP]
n9h59dbn6dQ	Polysics	Pretty Good[NLBP]
aFLMjIIlOI4	Polysics	Rocket[NLBP]
dDbyYwB7nqY	Polysics	You You You[NLBP]
nb1p29cuOTs	ROUAGE	Utsusemi[NLBP]
_A-G2bDyjGY	THE BACK HORN	Mirai[SCALE 1.33][NLBP]
BPxvOpD6iD8	THE BACK HORN	Wana[SCALE 1.33][NLBP]
0O-5tC9YJeQ	THE ORAL CIGARETTES	5150[NLBP]
JffVvYhA54w	THE ORAL CIGARETTES	A-E-U-I[NLBP]
06CWzyvDUYc	THE ORAL CIGARETTES	Amy[NLBP]
WGot2jAViWY	THE ORAL CIGARETTES	BLACK MEMORY[NLBP]
rj5YdTd1oQI	THE ORAL CIGARETTES	CATCH ME[NLBP]
xTIEsgEElEw	THE ORAL CIGARETTES	Color Tokyo[NLBP]
u-G8CpRvQdE	THE ORAL CIGARETTES	DIP-BAP[NLBP]
X0g5BO6zyxA	THE ORAL CIGARETTES	Kantan'nakoto[NLBP]
2EIHak0--40	THE ORAL CIGARETTES	Kidzuke yo Baby[NLBP]
XxGfrghh3-o	THE ORAL CIGARETTES	Kirai[NLBP]
LqIbaicDP7A	THE ORAL CIGARETTES	Kishikaisei STORY[NLBP]
C-o8pTi6vd8	THE ORAL CIGARETTES	Kyōran Hey Kids!![NLBP]
36XkaF710Kw	THE ORAL CIGARETTES	Licorice[NLBP]
T6z8MiYSqjk	THE ORAL CIGARETTES	ONE'S AGAIN[NLBP]
aKmn4UjwM-c	THE ORAL CIGARETTES	PSYCHOPATH (Short version)[NLBP]
7ZtDMacbWGA	THE ORAL CIGARETTES	Shala La[NLBP]
Y7wS3_o06ks	THE ORAL CIGARETTES	Tonariau[NLBP]
bm5jnl4IIDY	THE ORAL CIGARETTES	Wagamama de gomakasanaide (revisions revenge)[NLBP]
L9IMylF6Zc0	THE ORAL CIGARETTES	Yōshi tanreina uso[NLBP]
LHueWQa8PlA	ZUKAN	Haiji[SCALE 1.33][NLBP]
v9V5aByfeCM	SEKAI NO OWARI	ANTI HERO[NLBP]
249YdrcCL0Y	SEKAI NO OWARI	Camellia sasanqua[NLBP]
qaQP0efeAQQ	SEKAI NO OWARI	Death Disco[NLBP]
zJbN7lW5Q0g	SEKAI NO OWARI	Dragon Night (Japanese)[NLTP]
gsVGf1T2Hfs	SEKAI NO OWARI	Dragon Night[NLBP]
mRyqm5ZrF5I	SEKAI NO OWARI	End Of The World[NLBP]
5KdxbSULD78	SEKAI NO OWARI	Food[NLBP]
dQMUaGRSsjI	SEKAI NO OWARI	Fukai Mori (Lyrics)[NLBP]
qfsr0S_QGOU	SEKAI NO OWARI	Hey Ho[NLBP]
w9V3x61D994	SEKAI NO OWARI	Honoo to Mori no Carnival[NLBP]
CsQNfkaG5z4	SEKAI NO OWARI	Illumination[NLBP]
OEIcqGVDUuk	SEKAI NO OWARI	LOVE SONG[NLBP]
sHJKQT4A3_0	SEKAI NO OWARI	MAGIC[NLBP]
KmvYJtdJoEw	SEKAI NO OWARI	Moonlight station (Twilight City at NISSAN STADIUM)[NLBP]
q9iozQDEO_U	SEKAI NO OWARI	Mr.Heartache[NLBP]
od8CNHDkIJA	SEKAI NO OWARI	Nijiiro no sensō[NLBP]
q6Ylz-EhtDo	SEKAI NO OWARI	Present[NLBP]
MslES96hLeo	SEKAI NO OWARI	RAIN (Short Version)[NLBP]
elzW2nlEVzI	SEKAI NO OWARI	RAIN[NLBP]
Mi9uNu35Gmk	SEKAI NO OWARI	RPG[NLBP]
hm1SerN9T3s	SEKAI NO OWARI	Sekai heiwa[NLTP]
vkcTN70fnXA	SEKAI NO OWARI	Snow Magic Fantasy[NLBP]
NYbZ4nR0g38	SEKAI NO OWARI	SOS[NLBP]
j0e9dESM60c	SEKAI NO OWARI	Starlight Parade (ARENA TOUR 2013)[NLBP]
CJbI-5kkkqc	SEKAI NO OWARI	Starlight Parade[NLBP]
5ipdCmaHrLM	SEKAI NO OWARI	Sutāgeizā[NLBP]
AgpPvtUzM9s	ABE Mao	19-Sai no uta[NLBP]
mvt21LGL7P0	ABE Mao	Anata ga sukina watashi[NLBP]
CS90aE8_dUQ	ABE Mao	Anata no koibito ni naritai no desu[NLBP]
Daw2Ol3nrnM	ABE Mao	Believe in yourself[NLBP]
EeXT_LWtGbo	ABE Mao	boyfriend[NLBP]
ifiHoVc-ywc	ABE Mao	Don't let me down[NLBP]
YnAU0pIbt_Q	ABE Mao	Furi ~i[NLBP]
7bBKHZpCvgw	ABE Mao	Hahate ゙ aru tame ni[NLBP]
D9ZDXP3Wmtw	ABE Mao	immorality[NLBP]
y9h5a4nC7Kw	ABE Mao	Itsu no hi mo[NLBP 250]
8XUpmqh-IW4	ABE Mao	K.I.S.S.I.N.G.[NLBP]
A7u6slgvgBc	ABE Mao	Kawaritai uta[NLBP]
bueyWMAQl60	ABE Mao	Kotae[NLBP]
E_GR8fI9xls	ABE Mao	Lonely[NLBP]
ICvoEpxqx-w	ABE Mao	Mada boku wa iki teru[NLBP]
ZkC0HLsMFJ4	ABE Mao	Mottō[NLBP]
jH_XgbEr94U	ABE Mao	Nan'nimo nai ima kara[NLBP]
_2Kk-Tkge50	ABE Mao	Saigo no watashi[NLBP]
FH4M4j7PLEE	ABE Mao	Sekai wa mada kimi o shiranai[NLBP]
UFeQ7sO93ik	ABE Mao	Soba ni ite[NLBP]
l4ohe8QuSec	ABE Mao	Sorezore aruki dasou[NLBP]
nnqsyj2OumA	ABE Mao	Tsutae taiko to[NLBP]
vhUgBUHCYJk	ABE Mao	Yasashī kotoba[NLBP]
dnPzpIuvphM	ABE Mao	You changed my life (short ver.)[NLTP]
NleWomXVjM4	AIMI	#BrandNewChoice[NLBP]
9qRCARM_LfE	AIMYON	Ai Wo Tsutaetaidatoka[NLBP]
E6iZ-xZ8x50	AIMYON	GOOD NIGHT BABY[NLBP]
pfGI91CFtRg	AIMYON	Harunohi[NLBP]
EEMwA8KZAqg	AIMYON	Ikite ita nda yo na[NLBP]
ARwVe1MYAUA	AIMYON	Kimi Wa Rock Wo Kikanai[NLBP 250]
mH6LoI63buY	AIMYON	Konya Kono Mama[NLBP]
0xSiBpUdW4E	AIMYON	Marigold[NLBP]
ViG28OU9crI	AIMYON	Yumeoi Bengal[NLBP]
cKJxuHG5TlY	Anly	Beautiful[NLBP]
q7a6TVQwlKE	Anly	Bye-Bye[NLBP]
h-DyMjiTFI0	Anly	Egao[NLBP]
biWWJdj2yhM	Anly	Emergency[NLBP]
JB5zUj26HNU	Anly	Moonlight[NLBP]
RgLIAjY2H48	Anly	Sunshine[NLBP]
hZj7Iykh7lo	Anly	Taiyoni Warae[NLBP]
g539TBoBXU4	ASÔ Natsuko	Brand New World[NLBP]
XwgkZimITeE	ASÔ Natsuko	MoonRise Romance[NLBP]
RegJmY2j3iM	ASÔ Natsuko	Movement of magic[SCALE 1.33][NLBP]
HeGJv7s01ek	ASÔ Natsuko	Perfect area complete![SCALE 1.33][NLBP]
2tqf6c9EM1w	ASÔ Natsuko	Programming for non-fiction[NLBP]
HyKZZXTqAfg	ASÔ Natsuko	Renai Koujou committee[NLBP]
nw6eGAFCfxY	Baby Kiy	Stay Together[NLBP]
Wo8Sw5_EkLg	Baby Kiy	Trouble[NLBP]
WL13Gosg96o	cenmilli	Shin sui[NLBP]
d2LFIclsT7M	cenmilli	Shinde shimaitai,[NLBP]
yEGo93UVSKI	cenmilli	Towairaito naito[NLBP]
FNTNvVGJXxc	cenmilli	wear[NLBP]
fy1PCrfD4jY	Eir Aoi	Accentier[NLBP]
fHo9NOXd6VQ	Eir Aoi	AURORA[NLBP]
WlSTu4CHtyU	Eir Aoi	Cobalt Sky[NLBP]
yNoFoa6exe8	Eir Aoi	Genesis[NLBP]
mTCESSzPZSw	Eir Aoi	Ignite[NLBP]
hAJM3DatBJY	Eir Aoi	INNOCENCE[NLBP]
p0m9Cq4ruoQ	Eir Aoi	KASUMI[NLBP]
nFyK-ajIAWU	Eir Aoi	Kuroiuta[NLBP]
MpAn09ZQdmE	Eir Aoi	Lapis Lazuri[NLBP]
9Smub2xU9Xc	Eir Aoi	MEMORIA -after days ver.-[NLBP]
Ewx0VDbmqvY	Eir Aoi	Niji No Oto[NLBP]
ROP5U29UWlI	Eir Aoi	Ryûsei[NLBP]
pJ4i199cQ-4	Eir Aoi	Sanbika[NLBP]
7n2-RbcyxFk	Eir Aoi	Shoegazer[NLBP]
Z2IwwyJUerk	Eir Aoi	Sirius[NLBP]
D1yFE_MChnQ	Eir Aoi	Tsubasa[NLBP]
K4Pu0rtB8_k	Eir Aoi	Tsunagaruomoi[NLBP]
vGsQywoE1CA	Eir Aoi	Yakusoku[NLBP]
HGixrvX1Yuk	ENA Fujita	EVIL IDOL SONG[NLBP]
XR-3sPJ4CnU	FUJIMOTO Miki	Boogie Train[NLBP 250]
FVOeJ9Pcz_o	HAMASAKI Ayumi	Last minute[NLBP]
lb3VImMSmV8	HAMASAKI Ayumi	Winter diary[NLBP]
Mf4Ohv_uHXc	I LOVE U ＠airi	Hōkago chi ~yokokappu odottemita[NLBP]
CUY79gGmpdc	I LOVE U ＠airi	Marine Dreamin'[NLBP]
d1rvn6_FdT0	I LOVE U ＠airi	Over The Time Dance[NLBP]
mx96XkivT4k	I LOVE U ＠airi	suki! Yuki! Honki majikku[NLBP]
H4SaBZ4-Brw	ITANO Tomomi	Fui ni[NLBP]
XNWn7FASHzQ	ITANO Tomomi	little[NLBP]
wqmh6nahCw8	KAMIKI Aya	Are you happy now? (Live)[NLBP]
OTXBwZRl5x4	KAMIKI Aya	Are you happy now?[SCALE 1.33][NLBP]
-AyMRTYOAZQ	KAMIKI Aya	Behind Those Hazel Eyes[SCALE 1.33][NLBP]
0k6g-WX-pV8	KAMIKI Aya	Crazy[SCALE 1.33][NLBP]
qAn9Aa-Pjgs	KAMIKI Aya	EVILÄLIVE[NLBP]
fqbEWNNIxds	KAMIKI Aya	Friends[NLBP]
fh2lk1lqFWA	KAMIKI Aya	Kimi Sarishi Yuuwaku (Live)[NLBP]
UvG4au5hh_Y	KAMIKI Aya	Pierrot[NLTP 250]
uDYI8h1inZA	KAMIKI Aya	Revolver[SCALE 1.33][NLBP]
BWQtrfh8gF4	KAMIKI Aya	Secret Code[SCALE 1.33][NLBP]
3Aaq4rH9vVk	KAMIKI Aya	Summer Memories[SCALE 1.33][NLBP]
l_lgowTGQrI	KAMIKI Aya	The Light[SCALE 1.33][NLBP]
LXHS4BX41uM	KASHIWAGI Yuki	Shortcake[NLBP]
izBA5lwmDeE	Kokia	I Believe (Bataclan 2007)[NLBP]
9tCOI9Dy3VY	Kumi Koda	Lovely[NLBP]
u59XwZlEi1U	LiSA	ASH[NLBP]
mLXIkCU8Fe0	LiSA	Believe in ourselves[NLBP]
oy9cWg7PSyM	LiSA	Brave Freak Out[NLBP]
pudLJ-L9ZI8	LiSA	Catch the Moment (Radio edit ver.)[NLBP]
wW80mkZaYxY	LiSA	Catch the Moment[NLBP]
KId6eunoiWk	LiSA	Crossing Field[NLBP]
0Q0xmvjGjII	LiSA	Datte Atashino Hero[NLBP]
fW-wsW9d27M	LiSA	Empty Mermaid[NLBP]
4dWbW5Y1W2s	LiSA	Hi Five![NLBP]
GJ4yehnerHQ	LiSA	Oath Sign[NLBP]
8mfjbI624lI	LiSA	Rally Go Round[NLBP]
IzhMzY5avLI	LiSA	Rising Hope[NLBP]
y6FCQWlKeJQ	LiSA	Shirushi[NLBP]
pukIKP5uZ04	LiSA	Träumerei[NLBP]
ePuy539e7lk	Luna Haruna	Ai Wo Utae[NLBP]
gHCf2k1PKCM	Luna Haruna	Kimi ga Kureta Sekai[NLBP]
R3Lu3mWDFtg	Luna Haruna	Kimiiro Signal[NLBP]
KagbpQE9nko	Luna Haruna	Kirameki Lifeline[NLBP]
CpDyF4pkbAs	Luna Haruna	Overfly[NLBP]
dh6gGmRQmyQ	Luna Haruna	Sora wa takaku kaze wa utau[NLBP]
rOPEd7mXt68	Luna Haruna	Startear[NLBP]
EFN1QJ5bDtA	Luna Haruna	Stella Breeze[NLBP]
irOdCvnjGKw	Luna Haruna	Sweet Fantasy[NLBP]
WXL67vhqg2w	Luna Haruna	Windia[NLBP]
0KTKVmajXZo	MANO Erina	Doki Doki Baby[NLBP]
H0te7bdKFIk	MANO Erina	Genki-sha de ikou![NLBP]
sSVJsRPFvwU	MANO Erina	Kono Mune No Tokimeki Wo (Close up Ver.)[NLBP]
bYYYgNqQySo	MANO Erina	Love & Peace = Paradise[NLBP]
NYzZz4CwfZQ	MANO Erina	My Days for You[NLBP]
FrvNPvD6epc	MANO Erina	NEXT MY SELF[NLTP]
G0pZo3E0I98	MANO Erina	Onegai dakara[NLBP]
TVBkEWWnN0Q	MANO Erina	Otome No Inori[NLTP]
mNFvZXou3A8	MANO Erina	Seishun no Serenade[NLBP]
JVQO8mJF2Ak	MANO Erina	Sekai wa samāpātī[NLBP]
kZYpUZ1IUlk	MANO Erina	Song for the DATE[NLBP]
uCXCtMhEoxk	MANO Erina	Tasogare Kōsate[NLBP]
-P_B2AC5WJM	Mashiro Ayano	Ideal White[NLBP]
HjIS8qeZZ9s	Mashiro Ayano	Newlook[NLBP]
2zE1EtkMLEk	Matchoss	On'na-tachi[NLBP]
ApKvmi-aHpI	Matchoss	Yuki-sōna hīrō to nukanikugi otoko[NLBP]
P0WjQaNYkok	MATSUURA Aya	Egao[NLBP]
ye0_7ogWawI	MATSUURA Aya	Momoiro Kataomoi[NLBP 250]
KyVEcB1-j9Q	MATSUURA Aya	Ne~e[NLBP]
PNuad3JiYUs	MICHISHIGE Sayumi	Loneliness Tokyo[NLTP]
UeYv80cvbtY	Mii	Besty #isshō nakama[NLBP]
IxMbJYfwJkI	Mii	What You Say[NLBP]
umaEimIPJbM	Mio Isayama	nijiiro love letter[NLBP]
hd7hhOeI0C8	miwa	aozora[SCALE 1.33][NLBP]
Opwa_PnqIpc	MIYAVI	Ahead Of The Light[NLBP]
xOULjXO_bL8	MIYAVI	Dancing With My Fingers[NLBP]
pjvXiurmXrc	MIYAVI	Fragile[NLBP]
t8nbgm-bPIU	MIYAVI	Real?[NLBP]
uunPriLNr30	MIYAVI	SURVIVE[NLBP]
PCco_YBsU3w	MIYAVI	The Others[NLBP]
QYXL0OA2K9M	MIYAVI	What's My Name (Live in New York City)[NLBP]
Fy_w2JIpAh4	NAKAGAWA Shōko	9lives[NLBP]
ZzFqGedMd1c	NAKAGAWA Shōko	Doridori[NLBP]
oL740l_S5Ng	NAKAGAWA Shōko	Namidano Tane, Egaono Hana[NLBP]
accaMcuY9FA	NAKAGAWA Shōko	RAY OF LIGHT[NLBP]
5pIe7rfHrGA	NAKAGAWA Shōko	Sakasama Sekai[NLBP]
PKRUKalbx3s	NAKAGAWA Shōko	Sorairo Days[NLBP]
N4kI02naOqk	Rei	COCOA[NLBP]
ngyFReGKt1k	Rei	Tumblin’[NLBP]
IQW3akMkmQ0	SAKAMOTO Miu	Phantom Girl's First Love[NLBP]
UKs1_kcWDkc	SAWA	Ai ni iku yo[NLBP]
H-eQMsu-Gmk	SAWA	Bijin hakumei ēge umi[NLBP]
0ChG_6dpN9o	SAWA	Dance, Balcony[NLBP]
Yn8JAtswIFI	SAWA	Dream About...[NLBP 125]
LoeAPizYqeU	SAWA	IjippariMermaid[NLBP]
rDLw5QSxqZw	SAWA	LastSnowFlakes[NLBP]
qEGTQnYS7_s	SAWA	ManyColors[NLBP]
qYWYIKReHH0	SAWA	Mr.Brown[NLBP]
DmvXzOuK1Wk	SAWA	Nagareboshi[NLBP]
Novab6JGYyA	SAWA	OborogeDancin[NLBP]
wY14NHTNkzA	SAWA	One Direction Live While We're Young[NLTP]
QHvniyh-IbY	SAWA	RingaRinga[NLBP]
ZQRMdABCW20	SAWA	Shabon・Time Machine[NLBP]
VYrZK7KRkTQ	SAWA	Suddenly Chinese[NLBP]
lSFHpKPg-mM	SAWA	Tentai kansoku (BUMP OF CHICKEN cover)[NLBP]
T6ZBJTNWqLg	SAWA	Try Again![NLBP]
Z2La-GduPOI	SawanoHiroyuki[nZk]	Mizuki aLIEz (LIVE) Aldnoah.Zero OST[NLBP]
4gMXEd49rbg	SawanoHiroyuki[nZk] feat. Mizuki	&Z[NLBP]
YqFHIU4qc-k	SawanoHiroyuki[nZk] feat. Tielle	Into the Sky[NLBP]
PVuLPy8K0Ng	SHIMATANI Hitomi	〜Mermaid〜[NLBP]
vxzaDxg6nKA	SHINTANI Ryōko	ReTIME[NLBP]
uOIlXvvE91g	SUZUKI Airi	DISTANCE[NLTP]
SIapPZz7Dt4	SUZUKI Airi	Kimi No Suki Na Hito[NLBP]
cx-xhPmYCTc	SUZUKI Airi	Moment[NLBP]
xmtX5nq3ekk	SUZUKI Airi	start again[NLTP]
IXMYvr3xwjk	TAKIGAWA Alisa	Again[NLBP]
BaVvR42vqmo	TAKIGAWA Alisa	Iroasenai Hitomi[NLBP]
dc0Odw9DBYo	TAKIGAWA Alisa	Nastuno Hana[NLBP]
SgtetMfFAlU	TAKIGAWA Alisa	Night Light[NLBP]
f1-fokr6e8Y	TAKIGAWA Alisa	No Side[NLBP]
mybqTvHLhbI	TAKIGAWA Alisa	One for You[NLBP]
87ef1MZIOy8	TAKIGAWA Alisa	Sayonarano Yukue[NLBP]
lQsHD24bQr8	TAKIGAWA Alisa	Season[NLBP]
_ZI5XQh78Nc	TAKIGAWA Alisa	Tokyo[NLBP]
lzrMpiliJVg	TAKIGAWA Alisa	Wagamama (Domestic na Kanojo ED)[NLBP]
6zQ_jMbCsHA	TAKIGAWA Alisa	Wagamama[NLBP]
0YpvJFRut54	Tommy february6	♥KISS♥ ONE MORE TIME[NLBP]
715azTvKohg	Tommy february6	HOT CHOCOLAT[NLBP]
vWKQDZKMmbM	Tommy february6	Je t'aime[NLBP 250]
12FeRbr6A7g	Tommy february6	Love is forever[NLBP]
2PJa8-6ZJYU	Tommy february6	Magic in your eyes[NLBP 250]
XL5yjqsBAmk	Tommy heavenly6	Can you hear me?[NLBP]
CNbiia9EiJo	Tommy heavenly6	I'M YOUR DEVIL HALLOWEEN REMIX[NLBP]
PY-kRbBu1_k	Tommy heavenly6	monochrome rainbow[NLBP]
Dce-xpSlJL8	Tommy heavenly6	RUBY EYES[NLBP]
ql32v84pYlE	UEDA Marie	Bloomin'[NLBP]
h5qIy25I8fM	UEDA Marie	dining[NLBP]
4dF_Kt2AX84	UEDA Marie	FAR[NLBP]
4Okqfuk-yps	UEDA Marie	FRIDAY[NLBP]
gR7ko81rA-8	UEDA Marie	Furetara kiete shimau[NLBP]
Dxb4HBNbrBg	UEDA Marie	hanamoge[NLBP]
P_x8_Xyc0_8	UEDA Marie	Kare ni mamotte hoshī 10 no koto[NLBP]
z3rhE3kDpU0	UEDA Marie	Kokoro to karada[NLBP]
bHUhC4OQS2c	UEDA Marie	Mikansei-hin[NLBP]
SYFy5YWNF_M	UEDA Marie	REVOLVER[NLBP]
r9H2wXsuuPY	UEDA Marie	Sayonara no kawari ni kioku o keshita[NLBP]
bSmY7k6we-k	UEDA Marie	Sentimentalism[NLBP]
rqVbHjjZzHQ	UEDA Marie	Spectacle[NLTP]
vJvoZfeGN-0	UEDA Marie	Wakan'nai no wa iyada[NLBP]
gbYvL6yyhX0	UEDA Marie	Wasure nani kuchi dzuke[NLBP]
5DrfANfoG3M	UEDA Marie	Zakuro no mi[NLBP]
WaZuuopxLN8	WATANABE Mayu	Otona Jellybeans[NLBP]
GX63_e_grY0	YAMAMOTO Sayaka	Ichirinsō[NLBP]
MKINc7Rs6v8	Yuzu	Ikare[NLBP]
WgAhMfhdZ4c	Yuzu	tomo 〜 tabidachinotoki 〜[NLBP]
dOsHdtcJIRU	AN CAFE	NATSU KOI NATSU GAME[SCALE 1.33][NLBP]
vsKhN--iaY0	L'Arc〜en〜Ciel	Anata (You) (Live)[NLBP]
KrRU09D_e8Q	L'Arc〜en〜Ciel	Caress of Venus (Live)[NLBP]
gvOLm9hCpZE	L'Arc〜en〜Ciel	Daybreak's Bell[NLBP]
ubAwGxqmSeU	L'Arc〜en〜Ciel	Driver's High[SCALE 1.33][NLBP]
6ywIlwVTFz4	L'Arc〜en〜Ciel	Heaven's Drive[NLBP]
IV69BW3vYAI	L'Arc〜en〜Ciel	Hitomi no Jyuunin[NLBP]
nNrGJ8fd8Zg	L'Arc〜en〜Ciel	LINK[NLTP 250]
UYbPZmYfcmg	L'Arc〜en〜Ciel	My Heart Draws a Dream[NLBP 125]
74vygGXxqPk	L'Arc〜en〜Ciel	Neo Universe (Live)[NLBP]
M1l3tKi7R-A	L'Arc〜en〜Ciel	NEXUS 4[NLBP]
VejGqAvy4HY	L'Arc〜en〜Ciel	Seventh Heaven[NLBP]
O_oTvVOwd7s	L'Arc〜en〜Ciel	Stay Away (L'Arcasino)[NLBP]
1EPl6vAIZuo	L'Arc〜en〜Ciel	The Fourth Avenue Cafe (Live)[NLBP]
Ido193KVLiM	L'Arc〜en〜Ciel	Vivid Colors (Live)[NLBP]
kJt7GKMqjUQ	Moon Kana	Chimame[SCALE 1.33][NLBP]
olsd-6doRto	Moon Kana	Hebi Ichigo[NLBP 250]
G9yddV9zqIQ	Moon Kana	Kuuchuu Buranko[NLBP 250]
WnC5GaK9RfU	Psycho le Cému	Ai no uta[NLBP]
0NeD_BH6JoQ	Psycho le Cému	Chūn xià qiūdōng[SCALE 1.33][NLBP]
QNpOCwB920k	Psycho le Cému	Geki-ai merry go land[NLBP 250]
i_YX6Gb5JwY	Psycho le Cému	Inori[NLBP]
0MyTUTtV708	Psycho le Cému	LOVE IS DEAD[SCALE 1.33][NLBP]
GGniLFYGiF4	Psycho le Cému	Mèng fēngchē[SCALE 1.33][NLBP]
Hg1gisuvtb8	Psycho le Cému	Michinosora[SCALE 1.33][NLBP]
7UL_7QiJqOE	Psycho le Cému	Omoidearuki[NLBP 250]
lNB1XDuXtZM	Psycho le Cému	Prism[NLBP 250]
Uyskb03bo3g	Psycho le Cému	Revenger - kurayami no fukushū-sha -[NLBP]
wEk05VoTdvw	Psycho le Cému	Roman Hikou[NLBP 250]
ieW30L2aqa8	Psycho le Cému	STAR TRAIN[NLBP]
Z0WsZwXcGsQ	Psycho le Cému	With[SCALE 1.33][NLBP]
pjW6nfPCcZU	Psycho le Cému	Yume Kazaguruma[SCALE 1.33][NLBP]
LPtYIwbBYkU	the GazettE	Akai One Piece ~ Live Makuhari Messe[NLBP]
m2f3jQfbRl8	the GazettE	DOGMA[NLBP]
LnhwQf1Y0PU	the GazettE	Falling[NLBP]
OQR5bj65Wyg	the GazettE	INSIDE BEAST[NLBP]
3khQd1dnaP0	the GazettE	PLEDGE[NLBP]
NotPn6EjDsM	the GazettE	Red[NLBP]
nTMYDaBYsH8	the GazettE	REMEMBER THE URGE[NLBP]
Yjuh0a1fVgM	the GazettE	UGLY[NLBP]
2HkNboQyKVM	the GazettE	UNDYING[NLBP]
LnlgkuAak5Y	the GazettE	VORTEX[NLBP]
MLfMrBfqCu8	YUI	again (Short version)[NLBP]
B7uMdmCQabc	YUI	again[NLBP]
uHV-zUQWieM	YUI	CHE.R.RY (Lyrics)[NLBP]
GA7vroYoqdQ	YUI	Cloudy[NLBP]
olABR7VRdgI	YUI	Crossroad[NLBP]
MRlBEWScBk8	YUI	Driving Today[NLBP]
h9WWfh_WZ6M	YUI	Feel my soul (2012 version)[NLBP]
B4oXy6ZA0vU	YUI	Fight[NLBP]
ZFsjnFiC9lM	YUI	GLORIA[NLBP]
s923yctTH3c	YUI	HELLO[NLBP]
5ZGVPQ_x2hU	YUI	Laugh Away[NLBP]
bvTVynFMI-Y	YUI	LIFE[NLBP]
oc19OCkOlmU	YUI	Lock On[NLBP]
pqZqGQbPh0s	YUI	Muffler[NLBP]
3RIl5XZrsHI	YUI	My Generation[NLBP]
lpaKx9fTSQ0	YUI	Namidairo[NLBP]
HaJpFg1p-S8	YUI	Never Say Die[NLBP]
kOnyNF49a_g	YUI	Oh My God[NLBP]
XufwYw6RNbE	YUI	Please Stay With Me[NLBP]
x1H29X0M1KM	YUI	Rain (Short version)[NLBP]
ZSKtS2FYol0	YUI	Rain[NLBP]
VS_pXwWN2y8	YUI	rolling star[NLBP]
046E5kdTMw4	YUI	Sea[NLBP]
m8skkeO9g6s	YUI	Skyline[NLBP]
TbgG3x9EWVk	YUI	Tomorrow's Way[NLBP]
Lzequrmeg1M	YUI	YOU[NLBP]
6pOkLIzeHdQ	YUI	Your Heaven[NLBP]
